-1	0	0	-1	0	0	-1	0	0	-1	0	0	-1	0	0	-1	0	0	-1	0	0	-1	0	0	-1	0	0	-1	0	0	-1	0	0	-1	0	0	-1	0	0	-1	0	0	-1	0	0	-1	0	0	-1	0	0	-1	0	0	-1	0	0	-1	0	0	-1	0	0	-1	0	0	-1	0	0	-1	0	0	-1	0	0	-1	0	0	-1	0	0	-1	0	0	-1	0	0	-1	0	0
-1	0	0	-1	0	0	-1	0	0	-1	0	0	-1	0	0	-1	0	0	-1	0	0	-1	0	0	-1	0	0	-1	0	0	-1	0	0	-1	0	0	-1	0	0	-1	0	0	-1	0	0	-1	0	0	-1	0	0	-1	0	0	-1	0	0	-1	0	0	-1	0	0	-1	0	0	-1	0	0	-1	0	0	-1	0	0	-1	0	0	-1	0	0	-1	0	0	-1	0	0	-1	0	0
-1	0	0	-1	0	0	-1	0	0	-1	0	0	-1	0	0	-1	0	0	6	4	3	6	5	3	-1	0	0	-1	0	0	6	4	3	6	5	3	-1	0	0	-1	0	0	-1	0	0	-1	0	0	6	4	3	6	5	3	-1	0	0	-1	0	0	6	4	3	6	5	3	-1	0	0	-1	0	0	-1	0	0	-1	0	0	-1	0	0	-1	0	0	-1	0	0	-1	0	0
-1	0	0	6	10	1	6	11	1	-1	0	0	-1	0	0	-1	0	0	6	4	3	6	5	3	6	11	0	-1	0	0	6	4	3	6	5	3	-1	0	0	6	11	0	6	11	0	6	11	0	6	4	3	6	5	3	-1	0	0	-1	0	0	6	4	3	6	5	3	-1	0	0	6	11	0	6	11	0	-1	0	0	6	10	1	6	11	1	-1	0	0	-1	0	0
-1	0	0	6	10	2	6	11	2	-1	0	0	-1	0	0	-1	0	0	6	4	3	6	5	3	-1	0	0	-1	0	0	6	4	3	6	5	3	-1	0	0	-1	0	0	-1	0	0	-1	0	0	6	4	3	6	5	3	-1	0	0	-1	0	0	6	4	3	6	5	3	-1	0	0	-1	0	0	-1	0	0	-1	0	0	6	10	2	6	11	2	-1	0	0	-1	0	0
-1	0	0	5	4	6	5	4	6	-1	0	0	-1	0	0	-1	0	0	6	4	3	6	5	3	-1	0	0	-1	0	0	6	4	3	6	5	3	-1	0	0	-1	0	0	-1	0	0	-1	0	0	6	4	3	6	5	3	-1	0	0	-1	0	0	6	4	3	6	5	3	-1	0	0	-1	0	0	-1	0	0	-1	0	0	5	4	6	5	4	6	-1	0	0	-1	0	0
-1	0	0	-1	0	0	-1	0	0	-1	0	0	-1	0	0	-1	0	0	6	4	4	6	5	4	-1	0	0	-1	0	0	6	4	4	6	5	4	-1	0	0	-1	0	0	-1	0	0	-1	0	0	6	4	4	6	5	4	-1	0	0	-1	0	0	6	4	4	6	5	4	-1	0	0	-1	0	0	-1	0	0	-1	0	0	-1	0	0	-1	0	0	-1	0	0	-1	0	0
5	5	7	-1	0	0	7	0	1	-1	0	0	-1	0	0	-1	0	0	-1	0	0	-1	0	0	-1	0	0	-1	0	0	-1	0	0	-1	0	0	-1	0	0	-1	0	0	-1	0	0	-1	0	0	-1	0	0	-1	0	0	-1	0	0	-1	0	0	-1	0	0	-1	0	0	-1	0	0	-1	0	0	-1	0	0	-1	0	0	-1	0	0	-1	0	0	-1	0	0	-1	0	0
5	5	8	-1	0	0	7	0	2	7	0	1	-1	0	0	-1	0	0	-1	0	0	-1	0	0	-1	0	0	-1	0	0	-1	0	0	-1	0	0	-1	0	0	-1	0	0	-1	0	0	-1	0	0	-1	0	0	-1	0	0	-1	0	0	-1	0	0	-1	0	0	-1	0	0	-1	0	0	-1	0	0	-1	0	0	-1	0	0	-1	0	0	-1	0	0	-1	0	0	-1	0	0
-1	0	0	-1	0	0	7	0	1	7	0	2	-1	0	0	-1	0	0	-1	0	0	-1	0	0	-1	0	0	-1	0	0	-1	0	0	-1	0	0	-1	0	0	7	2	0	7	2	0	-1	0	0	-1	0	0	-1	0	0	-1	0	0	-1	0	0	-1	0	0	-1	0	0	-1	0	0	-1	0	0	-1	0	0	-1	0	0	-1	0	0	-1	0	0	-1	0	0	-1	0	0
-1	0	0	7	5	9	7	0	2	7	0	1	-1	0	0	-1	0	0	-1	0	0	-1	0	0	-1	0	0	-1	0	0	-1	0	0	7	10	8	7	11	8	-1	0	0	-1	0	0	-1	0	0	7	10	8	7	11	8	-1	0	0	-1	0	0	-1	0	0	7	10	8	7	11	8	-1	0	0	-1	0	0	-1	0	0	-1	0	0	-1	0	0	-1	0	0	-1	0	0
-1	0	0	7	5	9	-1	0	0	7	0	2	-1	0	0	-1	0	0	-1	0	0	7	2	0	-1	0	0	-1	0	0	-1	0	0	7	10	9	7	11	9	-1	0	0	-1	0	0	-1	0	0	7	10	9	7	11	9	-1	0	0	-1	0	0	-1	0	0	7	10	9	7	11	9	-1	0	0	-1	0	0	7	2	0	-1	0	0	-1	0	0	7	2	0	-1	0	0
-1	0	0	7	5	9	-1	0	0	-1	0	0	-1	0	0	-1	0	0	-1	0	0	-1	0	0	-1	0	0	-1	0	0	-1	0	0	-1	0	0	-1	0	0	-1	0	0	-1	0	0	-1	0	0	-1	0	0	-1	0	0	-1	0	0	-1	0	0	-1	0	0	-1	0	0	-1	0	0	-1	0	0	-1	0	0	-1	0	0	-1	0	0	7	2	0	7	2	0	7	2	0
7	0	1	-1	0	0	-1	0	0	-1	0	0	-1	0	0	-1	0	0	-1	0	0	-1	0	0	-1	0	0	-1	0	0	-1	0	0	-1	0	0	-1	0	0	-1	0	0	-1	0	0	-1	0	0	-1	0	0	-1	0	0	-1	0	0	-1	0	0	-1	0	0	-1	0	0	-1	0	0	-1	0	0	-1	0	0	-1	0	0	-1	0	0	-1	0	0	-1	0	0	5	4	7
7	0	2	7	5	9	-1	0	0	-1	0	0	-1	0	0	-1	0	0	-1	0	0	-1	0	0	-1	0	0	-1	0	0	-1	0	0	-1	0	0	-1	0	0	-1	0	0	-1	0	0	-1	0	0	-1	0	0	-1	0	0	-1	0	0	-1	0	0	-1	0	0	-1	0	0	-1	0	0	-1	0	0	-1	0	0	-1	0	0	-1	0	0	-1	0	0	-1	0	0	5	4	8
7	0	1	7	5	9	-1	0	0	-1	0	0	-1	0	0	-1	0	0	-1	0	0	-1	0	0	-1	0	0	-1	0	0	-1	0	0	-1	0	0	-1	0	0	-1	0	0	-1	0	0	-1	0	0	-1	0	0	-1	0	0	-1	0	0	-1	0	0	-1	0	0	-1	0	0	-1	0	0	-1	0	0	-1	0	0	-1	0	0	-1	0	0	-1	0	0	-1	0	0	-1	0	0
7	0	2	7	5	9	-1	0	0	-1	0	0	-1	0	0	-1	0	0	-1	0	0	-1	0	0	-1	0	0	-1	0	0	-1	0	0	-1	0	0	-1	0	0	-1	0	0	-1	0	0	-1	0	0	-1	0	0	-1	0	0	7	2	0	-1	0	0	-1	0	0	-1	0	0	-1	0	0	-1	0	0	-1	0	0	-1	0	0	-1	0	0	-1	0	0	-1	0	0	-1	0	0
-1	0	0	-1	0	0	-1	0	0	-1	0	0	-1	0	0	-1	0	0	7	2	0	-1	0	0	-1	0	0	-1	0	0	-1	0	0	-1	0	0	-1	0	0	-1	0	0	-1	0	0	-1	0	0	-1	0	0	-1	0	0	-1	0	0	-1	0	0	-1	0	0	-1	0	0	-1	0	0	-1	0	0	-1	0	0	-1	0	0	-1	0	0	-1	0	0	-1	0	0	5	4	7
-1	0	0	-1	0	0	-1	0	0	-1	0	0	-1	0	0	-1	0	0	-1	0	0	-1	0	0	-1	0	0	-1	0	0	-1	0	0	7	10	8	7	11	8	-1	0	0	-1	0	0	-1	0	0	7	10	8	7	11	8	-1	0	0	-1	0	0	-1	0	0	7	10	8	7	11	8	-1	0	0	-1	0	0	-1	0	0	-1	0	0	-1	0	0	-1	0	0	5	4	8
-1	0	0	-1	0	0	-1	0	0	-1	0	0	-1	0	0	-1	0	0	-1	0	0	-1	0	0	-1	0	0	-1	0	0	-1	0	0	7	10	9	7	11	9	-1	0	0	-1	0	0	-1	0	0	7	10	9	7	11	9	-1	0	0	-1	0	0	-1	0	0	7	10	9	7	11	9	-1	0	0	-1	0	0	-1	0	0	-1	0	0	-1	0	0	7	2	0	7	2	0
-1	0	0	-1	0	0	-1	0	0	-1	0	0	-1	0	0	-1	0	0	-1	0	0	-1	0	0	-1	0	0	-1	0	0	-1	0	0	-1	0	0	-1	0	0	-1	0	0	-1	0	0	-1	0	0	-1	0	0	-1	0	0	-1	0	0	-1	0	0	-1	0	0	-1	0	0	-1	0	0	-1	0	0	7	2	0	-1	0	0	-1	0	0	-1	0	0	7	2	0	7	2	0
5	5	7	-1	0	0	-1	0	0	-1	0	0	-1	0	0	-1	0	0	-1	0	0	-1	0	0	-1	0	0	-1	0	0	-1	0	0	-1	0	0	-1	0	0	-1	0	0	-1	0	0	-1	0	0	-1	0	0	-1	0	0	-1	0	0	-1	0	0	-1	0	0	-1	0	0	7	2	0	-1	0	0	-1	0	0	-1	0	0	-1	0	0	-1	0	0	7	2	0	-1	0	0
5	5	8	-1	0	0	-1	0	0	-1	0	0	-1	0	0	-1	0	0	-1	0	0	-1	0	0	-1	0	0	-1	0	0	-1	0	0	-1	0	0	-1	0	0	-1	0	0	-1	0	0	-1	0	0	-1	0	0	-1	0	0	-1	0	0	-1	0	0	7	2	0	7	2	0	7	2	0	7	2	0	-1	0	0	-1	0	0	-1	0	0	-1	0	0	-1	0	0	7	2	0
-1	0	0	-1	0	0	-1	0	0	-1	0	0	-1	0	0	-1	0	0	-1	0	0	-1	0	0	-1	0	0	-1	0	0	-1	0	0	-1	0	0	-1	0	0	-1	0	0	-1	0	0	-1	0	0	-1	0	0	-1	0	0	-1	0	0	-1	0	0	-1	0	0	-1	0	0	-1	0	0	-1	0	0	-1	0	0	-1	0	0	-1	0	0	-1	0	0	-1	0	0	-1	0	0
-1	0	0	-1	0	0	-1	0	0	-1	0	0	-1	0	0	-1	0	0	-1	0	0	-1	0	0	-1	0	0	-1	0	0	-1	0	0	-1	0	0	-1	0	0	-1	0	0	-1	0	0	-1	0	0	-1	0	0	-1	0	0	-1	0	0	-1	0	0	-1	0	0	-1	0	0	-1	0	0	-1	0	0	-1	0	0	-1	0	0	-1	0	0	-1	0	0	-1	0	0	-1	0	0
