-1	0	0	-1	0	0	2	0	2	2	1	2	2	1	2	2	1	2	2	2	2	0	3	1	0	3	1	0	3	1	0	3	1	0	3	1	0	3	1	0	3	1	0	3	1	0	3	1	0	3	1	0	3	1	0	3	1	0	3	1	0	3	1	0	3	1	0	3	1	0	3	1	0	3	1	0	3	1	0	3	1	0	3	1	0	3	1	0	3	1
-1	0	0	-1	0	0	2	0	2	2	1	2	2	1	2	2	1	2	2	2	2	0	3	1	0	3	1	0	3	1	0	3	1	0	3	1	0	3	1	0	3	1	0	3	1	0	3	1	0	3	1	0	3	1	0	3	1	0	3	1	0	3	1	0	3	1	0	3	1	0	3	1	0	3	1	0	3	1	0	3	1	0	3	1	0	3	1	0	3	1
-1	0	0	-1	0	0	2	0	2	2	1	2	2	1	2	2	1	2	2	2	2	0	3	1	0	3	1	0	3	1	0	3	1	0	3	1	0	3	1	0	3	1	0	3	1	0	3	1	0	3	1	0	3	1	0	3	1	0	3	1	0	3	1	0	3	1	0	3	1	0	3	1	0	3	1	0	3	1	0	3	1	0	3	1	0	3	1	0	3	1
-1	0	0	-1	0	0	2	0	2	2	1	2	2	1	2	2	1	2	2	2	2	0	3	1	0	3	1	0	3	1	0	3	1	0	3	1	0	3	1	0	3	1	0	3	1	0	3	1	0	3	1	0	3	1	0	3	1	0	3	1	0	3	1	0	3	1	0	3	1	0	3	1	0	3	1	0	3	1	0	3	1	0	3	1	0	3	1	0	3	1
-1	0	0	-1	0	0	2	0	2	2	1	2	2	1	2	2	1	2	2	2	2	0	3	1	0	3	1	0	3	1	0	3	1	0	3	1	0	3	1	0	3	1	0	3	1	0	3	1	0	3	1	0	3	1	0	3	1	0	3	1	0	3	1	0	3	1	0	3	1	0	3	1	0	3	1	0	3	1	0	3	1	0	3	1	0	3	1	0	3	1
-1	0	0	-1	0	0	2	0	2	2	1	2	2	1	2	2	1	2	2	2	2	0	3	1	0	3	1	0	3	1	0	3	1	0	3	1	0	3	1	0	3	1	0	3	1	0	3	1	0	3	1	0	3	1	0	3	1	0	3	1	0	3	1	0	3	1	0	3	1	0	3	1	0	3	1	0	3	1	0	3	1	0	3	1	0	3	1	0	3	1
-1	0	0	-1	0	0	2	0	2	2	1	2	2	1	2	2	1	2	2	2	2	0	3	1	0	3	1	0	3	1	0	3	1	0	3	1	0	3	1	0	3	1	0	3	1	0	3	1	0	3	1	0	3	1	0	3	1	0	3	1	0	3	1	0	3	1	0	3	1	0	3	1	0	3	1	0	3	1	0	3	1	0	3	1	0	3	1	0	3	1
-1	0	0	-1	0	0	2	0	2	2	1	2	2	1	2	2	1	2	2	2	2	0	3	1	0	3	1	0	3	1	0	3	1	0	3	1	0	3	1	0	3	1	0	3	1	0	3	1	0	3	1	0	3	1	0	3	1	0	3	1	0	3	1	0	3	1	0	3	1	0	3	1	0	3	1	0	3	1	0	3	1	0	3	1	0	3	1	0	3	1
-1	0	0	-1	0	0	2	0	2	2	1	2	2	1	2	2	1	2	2	2	2	0	3	1	0	3	1	0	3	1	0	3	1	0	3	1	0	3	1	0	3	1	0	3	1	0	3	1	0	3	1	0	3	1	0	3	1	0	3	1	0	3	1	0	3	1	0	3	1	0	3	1	0	3	1	0	3	1	0	3	1	0	3	1	0	3	1	0	3	1
-1	0	0	-1	0	0	2	0	2	2	1	2	2	1	2	2	1	2	2	2	2	0	3	1	0	3	1	0	3	1	0	3	1	0	3	1	0	3	1	0	3	1	0	3	1	0	3	1	0	3	1	0	3	1	0	3	1	0	3	1	0	3	1	0	3	1	0	3	1	0	3	1	0	3	1	0	3	1	0	3	1	0	3	1	0	3	1	0	3	1
-1	0	0	-1	0	0	2	0	2	2	1	2	2	1	2	2	1	2	2	2	2	0	3	1	0	3	1	0	3	1	0	3	1	0	3	1	0	3	1	0	3	1	0	3	1	0	3	1	0	3	1	0	3	1	0	3	1	0	3	1	0	3	1	0	3	1	0	3	1	0	3	1	0	3	1	0	3	1	0	3	1	0	3	1	0	3	1	0	3	1
-1	0	0	-1	0	0	2	0	2	2	1	2	2	1	2	2	1	2	2	2	2	0	3	1	0	3	1	0	3	1	0	3	1	0	3	1	0	3	1	0	3	1	0	3	1	0	3	1	0	3	1	0	3	1	0	3	1	0	3	1	0	3	1	0	3	1	0	3	1	0	3	1	0	3	1	0	3	1	0	3	1	0	3	1	0	3	1	0	3	1
-1	0	0	-1	0	0	2	0	2	2	1	2	2	1	2	2	1	2	2	2	2	0	3	1	0	3	1	0	3	1	0	3	1	0	3	1	0	3	1	0	3	1	0	3	1	0	3	1	0	3	1	0	3	1	0	3	1	0	3	1	0	3	1	0	3	1	0	3	1	0	3	1	0	3	1	0	3	1	0	3	1	0	3	1	0	3	1	0	3	1
-1	0	0	-1	0	0	2	0	2	2	1	2	2	1	2	2	1	2	2	2	2	0	3	1	0	3	1	0	3	1	0	3	1	0	3	1	0	3	1	0	3	1	0	3	1	0	3	1	0	3	1	0	3	1	0	3	1	0	3	1	0	3	1	0	3	1	0	3	1	0	3	1	0	3	1	0	3	1	0	3	1	0	3	1	0	3	1	0	3	1
-1	0	0	-1	0	0	2	0	2	2	1	2	2	1	2	2	1	2	2	2	2	0	3	1	0	3	1	0	3	1	0	3	1	0	3	1	0	3	1	0	3	1	0	3	1	0	3	1	0	3	1	0	3	1	0	3	1	0	3	1	0	3	1	0	3	1	0	3	1	0	3	1	0	3	1	0	3	1	0	3	1	0	3	1	0	3	1	0	3	1
-1	0	0	-1	0	0	2	0	2	2	1	2	2	1	2	2	1	2	2	2	2	0	3	1	0	3	1	0	3	1	0	3	1	0	3	1	0	3	1	0	3	1	0	3	1	0	3	1	0	3	1	0	3	1	0	3	1	0	3	1	0	3	1	0	3	1	0	3	1	0	3	1	0	3	1	0	3	1	0	3	1	0	3	1	0	3	1	0	3	1
-1	0	0	-1	0	0	2	0	2	2	1	2	2	1	2	2	1	2	2	2	2	0	3	1	0	3	1	0	3	1	0	3	1	0	3	1	0	3	1	0	3	1	0	3	1	0	3	1	0	3	1	0	3	1	0	3	1	0	3	1	0	3	1	0	3	1	0	3	1	0	3	1	0	3	1	0	3	1	0	3	1	0	3	1	0	3	1	0	3	1
-1	0	0	-1	0	0	2	0	2	2	1	2	2	1	2	2	1	2	2	2	2	0	3	1	0	3	1	0	3	1	0	3	1	0	3	1	0	3	1	0	3	1	0	3	1	0	3	1	0	3	1	0	3	1	0	3	1	0	3	1	0	3	1	0	3	1	0	3	1	0	3	1	0	3	1	0	3	1	0	3	1	0	3	1	0	3	1	0	3	1
-1	0	0	-1	0	0	2	0	2	2	1	2	2	1	2	2	1	2	2	2	2	0	3	1	0	3	1	0	3	1	0	3	1	0	3	1	0	3	1	0	3	1	0	3	1	0	3	1	0	3	1	0	3	1	0	3	1	0	3	1	0	3	1	0	3	1	0	3	1	0	3	1	0	3	1	0	3	1	0	3	1	0	3	1	0	3	1	0	3	1
-1	0	0	-1	0	0	2	0	2	2	1	2	2	1	2	2	1	2	2	2	2	0	3	1	0	3	1	0	3	1	0	3	1	0	3	1	0	3	1	0	3	1	0	3	1	0	3	1	0	3	1	0	3	1	0	3	1	0	3	1	0	3	1	0	3	1	0	3	1	0	3	1	0	3	1	0	3	1	0	3	1	0	3	1	0	3	1	0	3	1
-1	0	0	-1	0	0	2	0	2	2	1	2	2	1	2	2	1	2	2	2	2	0	3	1	0	3	1	0	3	1	0	3	1	0	3	1	0	3	1	0	3	1	0	3	1	0	3	1	0	3	1	0	3	1	0	3	1	0	3	1	0	3	1	0	3	1	0	3	1	0	3	1	0	3	1	0	3	1	0	3	1	0	3	1	0	3	1	0	3	1
-1	0	0	-1	0	0	2	0	2	2	1	2	2	1	2	2	1	2	2	2	2	0	3	1	0	3	1	0	3	1	0	3	1	0	3	1	0	3	1	0	3	1	0	3	1	0	3	1	0	3	1	0	3	1	0	3	1	0	3	1	0	3	1	0	3	1	0	3	1	0	3	1	0	3	1	0	3	1	0	3	1	0	3	1	0	3	1	0	3	1
-1	0	0	-1	0	0	2	0	2	2	1	2	2	1	2	2	1	2	2	2	2	0	3	1	0	3	1	0	3	1	0	3	1	0	3	1	0	3	1	0	3	1	0	3	1	0	3	1	0	3	1	0	3	1	0	3	1	0	3	1	0	3	1	0	3	1	0	3	1	0	3	1	0	3	1	0	3	1	0	3	1	0	3	1	0	3	1	0	3	1
-1	0	0	-1	0	0	2	0	2	2	1	2	2	1	2	2	1	2	2	2	2	0	3	1	0	3	1	0	3	1	0	3	1	0	3	1	0	3	1	0	3	1	0	3	1	0	3	1	0	3	1	0	3	1	0	3	1	0	3	1	0	3	1	0	3	1	0	3	1	0	3	1	0	3	1	0	3	1	0	3	1	0	3	1	0	3	1	0	3	1
-1	0	0	-1	0	0	2	0	2	2	1	2	2	1	2	2	1	2	2	2	2	0	3	1	0	3	1	0	3	1	0	3	1	0	3	1	0	3	1	0	3	1	0	3	1	0	3	1	0	3	1	0	3	1	0	3	1	0	3	1	0	3	1	0	3	1	0	3	1	0	3	1	0	3	1	0	3	1	0	3	1	0	3	1	0	3	1	0	3	1
-1	0	0	-1	0	0	2	0	2	2	1	2	2	1	2	2	1	2	2	2	2	0	3	1	0	3	1	0	3	1	0	3	1	0	3	1	0	3	1	0	3	1	0	3	1	0	3	1	0	3	1	0	3	1	0	3	1	0	3	1	0	3	1	0	3	1	0	3	1	0	3	1	0	3	1	0	3	1	0	3	1	0	3	1	0	3	1	0	3	1
-1	0	0	-1	0	0	2	0	2	2	1	2	2	1	2	2	1	2	2	2	2	0	3	1	0	3	1	0	3	1	0	3	1	0	3	1	0	3	1	0	3	1	0	3	1	0	3	1	0	3	1	0	3	1	0	3	1	0	3	1	0	3	1	0	3	1	0	3	1	0	3	1	0	3	1	0	3	1	0	3	1	0	3	1	0	3	1	0	3	1
-1	0	0	-1	0	0	2	0	2	2	1	2	2	1	2	2	1	2	2	2	2	0	3	1	0	3	1	0	3	1	0	3	1	0	3	1	0	3	1	0	3	1	0	3	1	0	3	1	0	3	1	0	3	1	0	3	1	0	3	1	0	3	1	0	3	1	0	3	1	0	3	1	0	3	1	0	3	1	0	3	1	0	3	1	0	3	1	0	3	1
-1	0	0	-1	0	0	2	0	2	2	1	2	2	1	2	2	1	2	2	2	2	0	3	1	0	3	1	0	3	1	0	3	1	0	3	1	0	3	1	0	3	1	0	3	1	0	3	1	0	3	1	0	3	1	0	3	1	0	3	1	0	3	1	0	3	1	0	3	1	0	3	1	0	3	1	0	3	1	0	3	1	0	3	1	0	3	1	0	3	1
-1	0	0	-1	0	0	2	0	2	2	1	2	2	1	2	2	1	2	2	1	2	2	1	1	2	1	1	2	1	1	2	1	1	2	1	1	2	1	1	2	1	1	2	1	1	2	1	1	2	1	1	2	1	1	2	1	1	2	1	1	2	1	1	2	1	1	2	1	1	2	1	1	2	1	1	2	1	1	2	1	1	2	1	1	2	1	1	2	1	1
-1	0	0	-1	0	0	2	0	2	2	1	2	2	1	2	2	1	2	2	1	2	2	1	2	2	1	2	2	1	2	2	1	2	2	1	2	2	1	2	2	1	2	2	1	2	2	1	2	2	1	2	2	1	2	2	1	2	2	1	2	2	1	2	2	1	2	2	1	2	2	1	2	2	1	2	2	1	2	2	1	2	2	1	2	2	1	2	2	1	2
-1	0	0	-1	0	0	2	0	2	2	1	2	2	1	2	2	1	2	2	1	2	2	1	2	2	1	2	2	1	2	2	1	2	2	1	2	2	1	2	2	1	2	2	1	2	2	1	2	2	1	2	2	1	2	2	1	2	2	1	2	2	1	2	2	1	2	2	1	2	2	1	2	2	1	2	2	1	2	2	1	2	2	1	2	2	1	2	2	1	2
-1	0	0	-1	0	0	2	0	2	2	1	2	2	1	2	2	1	2	2	1	2	2	1	3	2	1	3	2	1	3	2	1	3	2	1	3	2	1	3	2	1	3	2	1	3	2	1	3	2	1	3	2	1	3	2	1	3	2	1	3	2	1	3	2	1	3	2	1	3	2	1	3	2	1	3	2	1	3	2	1	3	2	1	3	2	1	3	2	1	3
-1	0	0	-1	0	0	2	0	2	2	1	2	2	1	2	2	1	2	2	2	2	-1	0	0	-1	0	0	-1	0	0	-1	0	0	-1	0	0	-1	0	0	-1	0	0	-1	0	0	-1	0	0	-1	0	0	-1	0	0	-1	0	0	-1	0	0	-1	0	0	-1	0	0	-1	0	0	-1	0	0	-1	0	0	-1	0	0	-1	0	0	-1	0	0	-1	0	0	-1	0	0
-1	0	0	-1	0	0	2	0	2	2	1	2	2	1	2	2	1	2	2	2	2	-1	0	0	-1	0	0	-1	0	0	-1	0	0	-1	0	0	-1	0	0	-1	0	0	-1	0	0	-1	0	0	-1	0	0	-1	0	0	-1	0	0	-1	0	0	-1	0	0	-1	0	0	-1	0	0	-1	0	0	-1	0	0	-1	0	0	-1	0	0	-1	0	0	-1	0	0	-1	0	0
-1	0	0	-1	0	0	2	0	2	2	1	2	2	1	2	2	1	2	2	2	2	-1	0	0	-1	0	0	-1	0	0	-1	0	0	-1	0	0	-1	0	0	-1	0	0	-1	0	0	-1	0	0	-1	0	0	-1	0	0	-1	0	0	-1	0	0	-1	0	0	-1	0	0	-1	0	0	-1	0	0	-1	0	0	-1	0	0	-1	0	0	-1	0	0	-1	0	0	-1	0	0
-1	0	0	-1	0	0	2	0	2	2	1	2	2	1	2	2	1	2	2	2	2	-1	0	0	-1	0	0	-1	0	0	-1	0	0	-1	0	0	-1	0	0	-1	0	0	-1	0	0	-1	0	0	-1	0	0	-1	0	0	-1	0	0	-1	0	0	-1	0	0	-1	0	0	-1	0	0	-1	0	0	-1	0	0	-1	0	0	-1	0	0	-1	0	0	-1	0	0	-1	0	0
-1	0	0	-1	0	0	2	0	2	2	1	2	2	1	2	2	1	2	2	2	2	-1	0	0	-1	0	0	-1	0	0	-1	0	0	-1	0	0	-1	0	0	-1	0	0	-1	0	0	-1	0	0	-1	0	0	-1	0	0	-1	0	0	-1	0	0	-1	0	0	-1	0	0	-1	0	0	-1	0	0	-1	0	0	-1	0	0	-1	0	0	-1	0	0	-1	0	0	-1	0	0
-1	0	0	-1	0	0	2	0	2	2	1	2	2	1	2	2	1	2	2	2	2	-1	0	0	-1	0	0	-1	0	0	-1	0	0	-1	0	0	-1	0	0	-1	0	0	-1	0	0	-1	0	0	-1	0	0	-1	0	0	-1	0	0	-1	0	0	-1	0	0	-1	0	0	-1	0	0	-1	0	0	-1	0	0	-1	0	0	-1	0	0	-1	0	0	-1	0	0	-1	0	0
-1	0	0	-1	0	0	2	0	2	2	1	2	2	1	2	2	1	2	2	2	2	-1	0	0	-1	0	0	-1	0	0	-1	0	0	-1	0	0	-1	0	0	-1	0	0	-1	0	0	-1	0	0	-1	0	0	-1	0	0	-1	0	0	-1	0	0	-1	0	0	-1	0	0	-1	0	0	-1	0	0	-1	0	0	-1	0	0	-1	0	0	-1	0	0	-1	0	0	-1	0	0
-1	0	0	-1	0	0	2	0	2	2	1	2	2	1	2	2	1	2	2	2	2	-1	0	0	-1	0	0	-1	0	0	-1	0	0	-1	0	0	-1	0	0	-1	0	0	-1	0	0	-1	0	0	-1	0	0	-1	0	0	-1	0	0	-1	0	0	-1	0	0	-1	0	0	-1	0	0	-1	0	0	-1	0	0	-1	0	0	-1	0	0	-1	0	0	-1	0	0	-1	0	0
-1	0	0	-1	0	0	2	0	2	2	1	2	2	1	2	2	1	2	2	2	2	-1	0	0	-1	0	0	-1	0	0	-1	0	0	-1	0	0	-1	0	0	-1	0	0	-1	0	0	-1	0	0	-1	0	0	-1	0	0	-1	0	0	-1	0	0	-1	0	0	-1	0	0	-1	0	0	-1	0	0	-1	0	0	-1	0	0	-1	0	0	-1	0	0	-1	0	0	-1	0	0
-1	0	0	-1	0	0	2	0	2	2	1	2	2	1	2	2	1	2	2	2	2	-1	0	0	-1	0	0	-1	0	0	-1	0	0	-1	0	0	-1	0	0	-1	0	0	-1	0	0	-1	0	0	-1	0	0	-1	0	0	-1	0	0	-1	0	0	-1	0	0	-1	0	0	-1	0	0	-1	0	0	-1	0	0	-1	0	0	-1	0	0	-1	0	0	-1	0	0	-1	0	0
-1	0	0	-1	0	0	2	0	2	2	1	2	2	1	2	2	1	2	2	2	2	-1	0	0	-1	0	0	-1	0	0	-1	0	0	-1	0	0	-1	0	0	-1	0	0	-1	0	0	-1	0	0	-1	0	0	-1	0	0	-1	0	0	-1	0	0	-1	0	0	-1	0	0	-1	0	0	-1	0	0	-1	0	0	-1	0	0	-1	0	0	-1	0	0	-1	0	0	-1	0	0
-1	0	0	-1	0	0	2	0	2	2	1	2	2	1	2	2	1	2	2	2	2	-1	0	0	-1	0	0	-1	0	0	-1	0	0	-1	0	0	-1	0	0	-1	0	0	-1	0	0	-1	0	0	-1	0	0	-1	0	0	-1	0	0	-1	0	0	-1	0	0	-1	0	0	-1	0	0	-1	0	0	-1	0	0	-1	0	0	-1	0	0	-1	0	0	-1	0	0	-1	0	0
-1	0	0	-1	0	0	2	0	2	2	1	2	2	1	2	2	1	2	2	2	2	-1	0	0	-1	0	0	-1	0	0	-1	0	0	-1	0	0	-1	0	0	-1	0	0	-1	0	0	-1	0	0	-1	0	0	-1	0	0	-1	0	0	-1	0	0	-1	0	0	-1	0	0	-1	0	0	-1	0	0	-1	0	0	-1	0	0	-1	0	0	-1	0	0	-1	0	0	-1	0	0
-1	0	0	-1	0	0	2	0	2	2	1	2	2	1	2	2	1	2	2	2	2	-1	0	0	-1	0	0	-1	0	0	-1	0	0	-1	0	0	-1	0	0	-1	0	0	-1	0	0	-1	0	0	-1	0	0	-1	0	0	-1	0	0	-1	0	0	-1	0	0	-1	0	0	-1	0	0	-1	0	0	-1	0	0	-1	0	0	-1	0	0	-1	0	0	-1	0	0	-1	0	0
-1	0	0	-1	0	0	2	0	2	2	1	2	2	1	2	2	1	2	2	2	2	-1	0	0	-1	0	0	-1	0	0	-1	0	0	-1	0	0	-1	0	0	-1	0	0	-1	0	0	-1	0	0	-1	0	0	-1	0	0	-1	0	0	-1	0	0	-1	0	0	-1	0	0	-1	0	0	-1	0	0	-1	0	0	-1	0	0	-1	0	0	-1	0	0	-1	0	0	-1	0	0
-1	0	0	-1	0	0	2	0	2	2	1	2	2	1	2	2	1	2	2	2	2	-1	0	0	-1	0	0	-1	0	0	-1	0	0	-1	0	0	-1	0	0	-1	0	0	-1	0	0	-1	0	0	-1	0	0	-1	0	0	-1	0	0	-1	0	0	-1	0	0	-1	0	0	-1	0	0	-1	0	0	-1	0	0	-1	0	0	-1	0	0	-1	0	0	-1	0	0	-1	0	0
-1	0	0	-1	0	0	2	0	2	2	1	2	2	1	2	2	1	2	2	2	2	-1	0	0	-1	0	0	-1	0	0	-1	0	0	-1	0	0	-1	0	0	-1	0	0	-1	0	0	-1	0	0	-1	0	0	-1	0	0	-1	0	0	-1	0	0	-1	0	0	-1	0	0	-1	0	0	-1	0	0	-1	0	0	-1	0	0	-1	0	0	-1	0	0	-1	0	0	-1	0	0
-1	0	0	-1	0	0	2	0	2	2	1	2	2	1	2	2	1	2	2	2	2	-1	0	0	-1	0	0	-1	0	0	-1	0	0	-1	0	0	-1	0	0	-1	0	0	-1	0	0	-1	0	0	-1	0	0	-1	0	0	-1	0	0	-1	0	0	-1	0	0	-1	0	0	-1	0	0	-1	0	0	-1	0	0	-1	0	0	-1	0	0	-1	0	0	-1	0	0	-1	0	0
-1	0	0	-1	0	0	2	0	2	2	1	2	2	1	2	2	1	2	2	2	2	-1	0	0	-1	0	0	-1	0	0	-1	0	0	-1	0	0	-1	0	0	-1	0	0	-1	0	0	-1	0	0	-1	0	0	-1	0	0	-1	0	0	-1	0	0	-1	0	0	-1	0	0	-1	0	0	-1	0	0	-1	0	0	-1	0	0	-1	0	0	-1	0	0	-1	0	0	-1	0	0
-1	0	0	-1	0	0	2	0	2	2	1	2	2	1	2	2	1	2	2	2	2	-1	0	0	-1	0	0	-1	0	0	-1	0	0	-1	0	0	-1	0	0	-1	0	0	-1	0	0	-1	0	0	-1	0	0	-1	0	0	-1	0	0	-1	0	0	-1	0	0	-1	0	0	-1	0	0	-1	0	0	-1	0	0	-1	0	0	-1	0	0	-1	0	0	-1	0	0	-1	0	0
-1	0	0	-1	0	0	2	0	2	2	1	2	2	1	2	2	1	2	2	2	2	-1	0	0	-1	0	0	-1	0	0	-1	0	0	-1	0	0	-1	0	0	-1	0	0	-1	0	0	-1	0	0	-1	0	0	-1	0	0	-1	0	0	-1	0	0	-1	0	0	-1	0	0	-1	0	0	-1	0	0	-1	0	0	-1	0	0	-1	0	0	-1	0	0	-1	0	0	-1	0	0
-1	0	0	-1	0	0	2	0	2	2	1	2	2	1	2	2	1	2	2	2	2	-1	0	0	-1	0	0	-1	0	0	-1	0	0	-1	0	0	-1	0	0	-1	0	0	-1	0	0	-1	0	0	-1	0	0	-1	0	0	-1	0	0	-1	0	0	-1	0	0	-1	0	0	-1	0	0	-1	0	0	-1	0	0	-1	0	0	-1	0	0	-1	0	0	-1	0	0	-1	0	0
-1	0	0	-1	0	0	2	0	3	2	1	3	2	1	3	2	1	3	2	2	3	-1	0	0	-1	0	0	-1	0	0	-1	0	0	-1	0	0	-1	0	0	-1	0	0	-1	0	0	-1	0	0	-1	0	0	-1	0	0	-1	0	0	-1	0	0	-1	0	0	-1	0	0	-1	0	0	-1	0	0	-1	0	0	-1	0	0	-1	0	0	-1	0	0	-1	0	0	-1	0	0
-1	0	0	-1	0	0	-1	0	0	-1	0	0	-1	0	0	-1	0	0	-1	0	0	-1	0	0	-1	0	0	-1	0	0	-1	0	0	-1	0	0	-1	0	0	-1	0	0	-1	0	0	-1	0	0	-1	0	0	-1	0	0	-1	0	0	-1	0	0	-1	0	0	-1	0	0	-1	0	0	-1	0	0	-1	0	0	-1	0	0	-1	0	0	-1	0	0	-1	0	0	-1	0	0
-1	0	0	-1	0	0	-1	0	0	-1	0	0	1	8	0	1	9	0	1	9	0	1	10	0	-1	0	0	-1	0	0	-1	0	0	-1	0	0	-1	0	0	-1	0	0	-1	0	0	-1	0	0	-1	0	0	-1	0	0	-1	0	0	-1	0	0	-1	0	0	-1	0	0	-1	0	0	-1	0	0	-1	0	0	-1	0	0	-1	0	0	-1	0	0	-1	0	0	-1	0	0
-1	0	0	-1	0	0	-1	0	0	-1	0	0	1	8	1	1	9	1	1	9	1	1	10	1	-1	0	0	-1	0	0	-1	0	0	-1	0	0	-1	0	0	-1	0	0	-1	0	0	-1	0	0	-1	0	0	-1	0	0	-1	0	0	-1	0	0	-1	0	0	-1	0	0	-1	0	0	-1	0	0	-1	0	0	-1	0	0	-1	0	0	-1	0	0	-1	0	0	-1	0	0
-1	0	0	-1	0	0	-1	0	0	-1	0	0	1	8	2	1	9	2	1	9	2	1	10	2	-1	0	0	-1	0	0	-1	0	0	-1	0	0	-1	0	0	-1	0	0	-1	0	0	-1	0	0	-1	0	0	-1	0	0	-1	0	0	-1	0	0	-1	0	0	-1	0	0	-1	0	0	-1	0	0	-1	0	0	-1	0	0	-1	0	0	-1	0	0	-1	0	0	-1	0	0
