0	14	16	0	14	17	0	14	18	0	14	16	0	14	17	0	14	18	0	14	16	0	14	17	0	14	18	0	14	16	0	14	17	0	14	18	0	14	16	0	14	17	0	14	18	0	14	16	0	14	17	0	14	18	0	14	16	0	14	17
0	13	16	0	13	17	0	13	18	0	13	16	0	13	17	0	13	18	0	13	16	0	13	17	0	13	18	0	13	16	0	13	17	0	13	18	0	13	16	0	13	17	0	13	18	0	13	16	0	13	17	0	13	18	0	13	16	0	13	17
0	14	16	0	14	17	0	14	18	0	14	16	0	14	17	0	14	18	0	14	16	0	14	17	0	14	18	0	14	16	0	14	17	0	14	18	0	14	16	0	14	17	0	14	18	0	14	16	0	14	17	0	14	18	0	14	16	0	14	17
0	13	16	0	13	17	0	13	18	0	13	16	0	13	17	0	13	18	0	13	16	0	13	17	0	13	18	0	13	16	0	13	17	0	13	18	0	13	16	0	13	17	0	13	18	0	13	16	0	13	17	0	13	18	0	13	16	0	13	17
0	14	16	0	14	17	0	14	18	0	14	16	0	14	17	0	14	18	0	14	16	0	14	17	0	14	18	0	14	16	0	14	17	0	14	18	0	14	16	0	14	17	0	14	18	0	14	16	0	14	17	0	14	18	0	14	16	0	14	17
0	13	16	0	13	17	0	13	18	0	13	16	0	13	17	0	13	18	0	13	16	0	13	17	0	13	18	0	13	16	0	13	17	0	13	18	0	13	16	0	13	17	0	13	18	0	13	16	0	13	17	0	13	18	0	13	16	0	13	17
0	14	16	0	14	17	0	14	18	0	14	16	0	14	17	0	14	18	0	14	16	0	14	17	0	14	18	0	14	16	0	14	17	0	14	18	0	14	16	0	14	17	0	14	18	0	14	16	0	14	17	0	14	18	0	14	16	0	14	17
0	13	16	0	13	17	0	13	18	0	13	16	0	13	17	0	13	18	0	13	16	0	13	17	0	13	18	0	13	16	0	13	17	0	13	18	0	13	16	0	13	17	0	13	18	0	13	16	0	13	17	0	13	18	0	13	16	0	13	17
0	14	16	0	14	17	0	14	18	0	14	16	0	14	17	0	14	18	0	14	16	0	14	17	0	14	18	0	14	16	0	14	17	0	14	18	0	14	16	0	14	17	0	14	18	0	14	16	0	14	17	0	14	18	0	14	16	0	14	17
0	13	16	0	14	16	0	13	16	0	14	16	0	13	17	0	13	18	0	13	16	0	13	17	0	13	18	0	13	16	0	13	17	0	13	18	0	13	16	0	13	17	0	13	18	0	13	16	0	13	17	0	13	18	0	13	16	0	13	17
0	13	17	0	14	17	0	13	17	0	14	17	0	14	17	0	14	18	0	14	16	0	14	17	0	14	18	0	14	16	0	14	17	0	14	18	0	14	16	0	14	17	0	14	18	0	14	16	0	14	17	0	14	18	0	14	16	0	14	17
0	13	18	0	14	18	0	13	18	0	14	18	0	13	17	0	13	18	0	13	16	0	13	17	0	13	18	0	13	16	0	13	17	0	13	18	0	13	16	0	13	17	0	13	18	0	13	16	0	13	17	0	13	18	0	13	16	0	13	17
0	14	16	0	14	17	0	14	18	0	14	16	0	14	17	0	14	18	0	14	16	0	14	17	0	14	18	0	14	16	0	14	17	0	14	18	0	14	16	0	14	17	0	14	18	0	14	16	0	14	17	0	14	18	0	14	16	0	14	17
0	13	16	0	13	17	0	13	18	0	13	16	0	13	17	0	13	18	0	13	16	0	13	17	0	13	18	0	13	16	0	13	17	0	13	18	0	13	16	0	13	17	0	13	18	0	13	16	0	13	17	0	13	18	0	13	16	0	13	17
0	14	16	0	14	17	0	14	18	0	14	16	0	14	17	0	14	18	0	14	16	0	14	17	0	14	18	0	14	16	0	14	17	0	14	18	0	14	16	0	14	17	0	14	18	0	14	16	0	14	17	0	14	18	0	14	16	0	14	17
0	13	16	0	13	17	0	13	18	0	13	16	0	13	17	0	13	18	0	13	16	0	13	17	0	13	18	0	13	16	0	13	17	0	13	18	0	13	16	0	13	17	0	13	18	0	13	16	0	13	17	0	13	18	0	13	16	0	13	17
0	14	16	0	14	17	0	14	18	0	14	16	0	14	17	0	14	18	0	14	16	0	14	17	0	14	18	0	14	16	0	14	17	0	14	18	0	14	16	0	14	17	0	14	18	0	14	16	0	14	17	0	14	18	0	14	16	0	14	17
0	13	16	0	13	17	0	13	18	0	13	16	0	13	17	0	13	18	0	13	16	0	13	17	0	13	18	0	13	16	0	13	17	0	13	18	0	13	16	0	13	17	0	13	18	0	13	16	0	13	17	0	13	18	0	13	16	0	13	17
0	14	16	0	14	17	0	14	18	0	14	16	0	14	17	0	14	18	0	14	16	0	14	17	0	14	18	0	14	16	0	14	17	0	14	18	0	14	16	0	14	17	0	14	18	0	14	16	0	14	17	0	14	18	0	14	16	0	14	17
0	13	16	0	13	17	0	13	18	0	13	16	0	13	17	0	13	18	0	13	16	0	13	17	0	13	18	0	13	16	0	13	17	0	13	18	0	13	16	0	13	17	0	13	18	0	13	16	0	13	17	0	13	18	0	13	16	0	13	17
0	14	16	0	14	17	0	14	18	0	14	16	0	14	17	0	14	18	0	14	16	0	14	17	0	14	18	0	14	16	0	14	17	0	14	18	0	14	16	0	14	17	0	14	18	0	14	16	0	14	17	0	14	18	0	14	16	0	14	17
0	13	16	0	13	17	0	13	18	0	13	16	0	13	17	0	13	18	0	13	16	0	13	17	0	13	18	0	13	16	0	13	17	0	13	18	0	13	16	0	13	17	0	13	18	0	13	16	0	13	17	0	13	18	0	13	16	0	13	17
0	14	16	0	14	17	0	14	18	0	14	16	0	14	17	0	14	18	0	14	16	0	14	17	0	14	18	0	14	16	0	14	17	0	14	18	0	14	16	0	14	17	0	14	18	0	14	16	0	14	17	0	14	18	0	14	16	0	14	17
0	3	7	0	3	7	0	3	7	0	3	7	0	13	17	0	13	18	0	3	7	0	3	7	0	3	7	0	3	7	0	3	7	0	3	7	0	3	7	0	3	7	0	3	7	0	3	7	0	3	7	0	3	7	0	3	7	0	3	7
0	9	1	0	14	17	0	14	18	0	9	1	0	14	17	0	14	18	0	9	1	0	9	1	0	1	8	0	1	8	0	1	8	0	1	8	0	1	8	0	1	8	0	1	8	0	1	8	0	1	8	0	1	8	0	9	1	0	9	1
0	9	1	0	13	17	0	13	18	0	9	1	0	13	17	0	13	18	0	9	1	0	9	1	0	1	9	0	1	9	0	1	9	0	1	9	0	1	9	0	1	9	0	1	9	0	1	9	0	1	9	0	1	9	0	9	1	0	9	1
0	3	4	0	4	4	0	3	4	0	4	4	0	14	17	0	14	18	0	3	4	0	4	4	0	1	9	0	1	9	0	1	9	0	1	9	0	1	9	0	1	9	0	1	9	0	1	9	0	1	9	0	1	9	0	3	4	0	4	4
0	3	5	0	4	5	0	3	5	0	4	5	0	13	17	0	13	18	0	3	5	0	4	5	0	1	9	0	1	9	0	1	9	0	1	9	0	1	9	0	1	9	0	1	9	0	1	9	0	1	9	0	1	9	0	3	5	0	4	5
0	3	4	0	4	4	0	3	4	0	4	4	0	14	17	0	14	18	0	3	4	0	4	4	0	3	4	0	4	4	0	3	4	0	4	4	0	3	4	0	4	4	0	3	4	0	4	4	0	3	4	0	4	4	0	3	4	0	4	4
0	3	5	0	4	5	0	3	5	0	4	5	0	13	17	0	13	18	0	3	5	0	4	5	0	3	5	0	4	5	0	3	5	0	4	5	0	3	5	0	4	5	0	3	5	0	4	5	0	3	5	0	4	5	0	3	5	0	4	5
0	6	12	0	6	11	0	6	12	0	6	11	0	6	12	0	6	11	0	6	12	0	6	11	0	6	12	0	6	11	0	6	12	0	6	11	0	6	12	0	6	11	0	6	12	0	6	11	0	6	12	0	6	11	0	6	12	0	6	11
0	7	12	0	7	11	0	7	12	0	7	11	0	7	12	0	7	11	0	7	12	0	7	11	0	7	12	0	7	11	0	7	12	0	7	11	0	7	12	0	7	11	0	7	12	0	7	11	0	7	12	0	7	11	0	7	12	0	7	11
0	6	12	0	6	11	0	6	12	0	6	11	0	6	12	0	6	11	0	6	12	0	6	11	0	6	12	0	6	11	0	6	12	0	6	11	0	6	12	0	6	11	0	6	12	0	6	11	0	6	12	0	6	11	0	6	12	0	6	11
0	7	12	0	7	11	0	7	12	0	7	11	0	7	12	0	7	11	0	7	12	0	7	11	0	7	12	0	7	11	0	7	12	0	7	11	0	7	12	0	7	11	0	7	12	0	7	11	0	7	12	0	7	11	0	7	12	0	7	11
0	6	12	0	6	11	0	6	12	0	6	11	0	6	12	0	6	11	0	6	12	0	6	11	0	6	12	0	6	11	0	6	12	0	6	11	0	6	12	0	6	11	0	6	12	0	6	11	0	6	12	0	6	11	0	6	12	0	6	11
0	7	12	0	7	11	0	7	12	0	7	11	0	7	12	0	7	11	0	7	12	0	7	11	0	7	12	0	7	11	0	7	12	0	7	11	0	7	12	0	7	11	0	7	12	0	7	11	0	7	12	0	7	11	0	7	12	0	7	11
0	6	12	0	6	11	0	6	12	0	6	11	0	6	12	0	6	11	0	6	12	0	6	11	0	6	12	0	6	11	0	6	12	0	6	11	0	6	12	0	6	11	0	6	12	0	6	11	0	6	12	0	6	11	0	6	12	0	6	11
0	7	12	0	7	11	0	7	12	0	7	11	0	7	12	0	7	11	0	7	12	0	7	11	0	7	12	0	7	11	0	7	12	0	7	11	0	7	12	0	7	11	0	7	12	0	7	11	0	7	12	0	7	11	0	7	12	0	7	11
0	6	12	0	6	11	0	6	12	0	6	11	0	6	12	0	6	11	0	6	12	0	6	11	0	6	12	0	6	11	0	6	12	0	6	11	0	6	12	0	6	11	0	6	12	0	6	11	0	6	12	0	6	11	0	6	12	0	6	11
0	7	12	0	7	11	0	7	12	0	7	11	0	7	12	0	7	11	0	7	12	0	6	13	0	7	13	0	7	13	0	7	13	0	8	13	0	7	12	0	7	11	0	7	12	0	7	11	0	7	12	0	7	11	0	7	12	0	7	11
