0	2	1	0	3	1	1	0	5	1	0	3	1	0	4	1	0	5	0	2	1	0	3	1	1	0	5	1	0	3	1	0	4	1	0	5	1	0	3	1	0	4	1	0	5	1	0	3	1	0	4	1	0	5	1	0	3	1	0	4	1	0	5	1	0	3	1	0	4	1	0	5	1	0	3	1	0	4	1	0	5	1	0	3	1	0	4	1	0	5	1	0	3	1	0	4	1	0	5	1	0	3	1	0	4	1	0	5	1	0	3	1	0	4	1	0	5	1	0	3
0	2	2	0	3	2	1	1	5	1	1	3	1	1	4	1	1	5	0	2	2	0	3	2	1	1	5	1	1	3	1	1	4	1	1	5	1	1	3	1	1	4	1	1	5	1	1	3	1	1	4	1	1	5	1	1	3	1	1	4	1	1	5	1	1	3	1	1	4	1	1	5	1	1	3	1	1	4	1	1	5	1	1	3	1	1	4	1	1	5	1	1	3	1	1	4	1	1	5	1	1	3	1	1	4	1	1	5	1	1	3	1	1	4	1	1	5	1	1	3
0	2	1	0	3	1	1	0	5	1	0	3	1	0	4	1	0	5	0	2	1	0	3	1	1	0	5	1	0	3	1	0	4	1	0	5	1	0	3	1	0	4	1	0	5	1	0	3	1	0	4	1	0	5	1	0	3	1	0	4	1	0	5	1	0	3	1	0	4	1	0	5	1	0	3	1	0	4	1	0	5	1	0	3	1	0	4	1	0	5	1	0	3	1	0	4	1	0	5	1	0	3	1	0	4	1	0	5	1	0	3	1	0	4	1	0	5	1	0	3
0	2	2	0	3	2	1	1	5	1	1	3	1	1	4	1	1	5	0	2	2	0	3	2	1	1	5	1	1	3	1	1	4	1	1	5	1	1	3	1	1	4	1	1	5	1	1	3	1	1	4	1	1	5	1	1	3	1	1	4	1	1	5	1	1	3	1	1	4	1	1	5	1	1	3	1	1	4	1	1	5	1	1	3	1	1	4	1	1	5	1	1	3	1	1	4	1	1	5	1	1	3	1	1	4	1	1	5	1	1	3	1	1	4	1	1	5	1	1	3
0	2	1	0	3	1	1	0	5	1	0	3	1	0	4	1	0	5	0	2	1	0	3	1	1	0	5	1	0	3	1	0	4	1	0	5	0	2	1	0	3	1	0	2	1	0	3	1	0	2	1	0	3	1	0	2	1	0	3	1	0	2	1	0	3	1	0	2	1	0	3	1	0	2	1	0	3	1	1	0	5	1	0	3	1	0	4	1	0	5	1	0	3	1	0	4	1	0	5	1	0	3	1	0	4	1	0	5	1	0	3	1	0	4	1	0	5	1	0	3
0	2	2	0	3	2	1	1	5	1	1	3	1	1	4	1	1	5	0	2	2	0	3	2	1	1	5	1	1	3	1	1	4	1	1	5	0	2	2	0	3	2	0	2	2	0	3	2	0	2	2	0	3	2	0	2	2	0	3	2	0	2	2	0	3	2	0	2	2	0	3	2	0	2	2	0	3	2	1	1	5	1	1	3	1	1	4	1	1	5	1	1	3	1	1	4	1	1	5	1	1	3	1	1	4	1	1	5	1	1	3	1	1	4	1	1	5	1	1	3
0	2	1	0	3	1	1	0	5	1	0	3	1	0	4	1	0	5	0	2	1	0	3	1	1	0	5	1	0	3	1	0	4	1	0	5	0	2	3	0	3	3	0	2	3	0	3	3	0	2	3	0	3	3	0	2	3	0	3	3	0	2	3	0	3	3	0	2	3	0	3	3	0	2	1	0	3	1	1	0	5	1	0	3	1	0	4	1	0	5	1	0	3	1	0	4	1	0	5	1	0	3	1	0	4	1	0	5	1	0	3	1	0	4	1	0	5	1	0	3
0	2	2	0	3	2	1	1	5	1	1	3	1	1	4	1	1	5	0	2	2	0	3	2	1	1	5	1	1	3	1	1	4	1	1	5	0	2	4	0	3	4	0	2	4	0	3	4	0	2	4	0	3	4	0	2	4	0	3	4	0	2	4	0	3	4	0	2	4	0	3	4	0	2	2	0	3	2	1	1	5	1	1	3	1	1	4	1	1	5	1	1	3	1	1	4	1	1	5	1	1	3	1	1	4	1	1	5	1	1	3	1	1	4	1	1	5	1	1	3
0	2	1	0	3	1	1	0	5	1	0	3	1	0	4	1	0	5	0	2	1	0	3	1	1	0	5	1	0	3	1	0	4	1	0	5	1	0	3	1	0	4	1	0	5	1	0	3	1	0	4	1	0	5	1	0	3	1	0	4	1	0	5	1	0	3	1	0	4	1	0	5	0	2	1	0	3	1	1	0	5	1	0	3	1	0	4	1	0	5	1	0	3	1	0	4	1	0	5	1	0	3	1	0	4	1	0	5	1	0	3	1	0	4	1	0	5	1	0	3
0	2	2	0	3	2	1	1	5	1	1	3	1	1	4	1	1	5	0	2	2	0	3	2	1	1	5	1	1	3	1	1	4	1	1	5	1	1	3	1	1	4	1	1	5	1	1	3	1	1	4	1	1	5	1	1	3	1	1	4	1	1	5	1	1	3	1	1	4	1	1	5	0	2	2	0	3	2	1	1	5	1	1	3	1	1	4	1	1	5	1	1	3	1	1	4	1	1	5	1	1	3	1	1	4	1	1	5	1	1	3	1	1	4	1	1	5	1	1	3
0	2	1	0	3	1	1	0	5	1	0	3	1	0	4	1	0	5	0	2	1	0	3	1	0	2	1	0	3	1	0	2	1	0	3	1	0	2	1	0	3	1	0	2	1	0	3	1	0	2	1	0	3	1	0	2	1	0	3	1	0	2	1	0	3	1	0	2	1	0	3	1	0	2	1	0	3	1	0	2	1	0	3	1	0	2	1	0	3	1	0	2	1	0	3	1	0	2	1	0	3	1	1	0	4	1	0	5	1	0	3	1	0	4	1	0	5	1	0	3
0	2	2	0	3	2	1	1	5	1	1	3	1	1	4	1	1	5	0	2	2	0	3	2	0	2	2	0	3	2	0	2	2	0	3	2	0	2	2	0	3	2	0	2	2	0	3	2	0	2	2	0	3	2	0	2	2	0	3	2	0	2	2	0	3	2	0	2	2	0	3	2	0	2	2	0	3	2	0	2	2	0	3	2	0	2	2	0	3	2	0	2	2	0	3	2	0	2	2	0	3	2	1	1	4	1	1	5	1	1	3	1	1	4	1	1	5	1	1	3
0	2	1	0	3	1	1	0	5	1	0	3	1	0	4	1	0	5	0	2	3	0	3	3	0	2	3	0	3	3	0	2	3	0	3	3	0	2	3	0	3	3	0	2	3	0	3	3	0	2	3	0	3	3	0	2	3	0	3	3	0	2	3	0	3	3	0	2	3	0	3	3	0	2	3	0	3	3	0	2	3	0	3	3	0	2	3	0	3	3	0	2	1	0	3	1	0	2	1	0	3	1	1	0	4	1	0	5	1	0	3	1	0	4	1	0	5	1	0	3
0	2	2	0	3	2	1	1	5	1	1	3	1	1	4	1	1	5	0	2	4	0	3	4	0	2	4	0	3	4	0	2	4	0	3	4	0	2	4	0	3	4	0	2	4	0	3	4	0	2	4	0	3	4	0	2	4	0	3	4	0	2	4	0	3	4	0	2	4	0	3	4	0	2	4	0	3	4	0	2	4	0	3	4	0	2	4	0	3	4	0	2	2	0	3	2	0	2	2	0	3	2	1	1	4	1	1	5	1	1	3	1	1	4	1	1	5	1	1	3
0	2	1	0	3	1	1	0	5	1	0	3	1	0	4	1	0	5	1	0	3	1	0	4	1	0	5	1	0	3	1	0	4	1	0	5	1	0	3	1	0	4	1	0	5	1	0	3	1	0	4	1	0	5	1	0	3	1	0	4	1	0	5	1	0	3	1	0	4	1	0	5	1	0	3	1	0	4	1	0	5	1	0	3	1	0	4	1	0	5	0	2	1	0	3	1	0	2	1	0	3	1	1	0	4	1	0	5	1	0	3	1	0	4	1	0	5	1	0	3
0	2	2	0	3	2	1	1	5	1	1	3	1	1	4	1	1	5	1	1	3	1	1	4	1	1	5	1	1	3	1	1	4	1	1	5	1	1	3	1	1	4	1	1	5	1	1	3	1	1	4	1	1	5	1	1	3	1	1	4	1	1	5	1	1	3	1	1	4	1	1	5	1	1	3	1	1	4	1	1	5	1	1	3	1	1	4	1	1	5	0	2	2	0	3	2	0	2	2	0	3	2	1	1	4	1	1	5	1	1	3	1	1	4	1	1	5	1	1	3
0	2	1	0	3	1	0	2	1	0	3	1	0	2	1	0	3	1	0	2	1	0	3	1	0	2	1	0	3	1	0	2	1	0	3	1	0	2	1	0	3	1	0	2	1	0	3	1	0	2	1	0	3	1	0	2	1	0	3	1	1	0	5	1	0	3	1	0	4	1	0	5	1	0	3	1	0	4	0	2	1	0	3	1	0	2	1	0	3	1	0	2	1	0	3	1	0	2	1	0	3	1	1	0	4	1	0	5	1	0	3	1	0	4	1	0	5	1	0	3
0	2	2	0	3	2	0	2	2	0	3	2	0	2	2	0	3	2	0	2	2	0	3	2	0	2	2	0	3	2	0	2	2	0	3	2	0	2	2	0	3	2	0	2	2	0	3	2	0	2	2	0	3	2	0	2	2	0	3	2	1	1	5	1	1	3	1	1	4	1	1	5	1	1	3	1	1	4	0	2	2	0	3	2	0	2	2	0	3	2	0	2	2	0	3	2	0	2	2	0	3	2	1	1	4	1	1	5	1	1	3	1	1	4	1	1	5	1	1	3
0	2	3	0	3	3	0	2	3	0	3	3	0	2	3	0	3	3	0	2	3	0	3	3	0	2	3	0	3	3	0	2	3	0	3	3	0	2	3	0	3	3	0	2	3	0	3	3	0	2	3	0	3	3	0	2	1	0	3	1	1	0	5	1	0	3	1	0	4	1	0	5	1	0	3	1	0	4	0	2	1	0	3	1	0	2	1	0	3	1	0	2	1	0	3	1	0	2	1	0	3	1	1	0	4	1	0	5	1	0	3	1	0	4	1	0	5	1	0	3
0	2	4	0	3	4	0	2	4	0	3	4	0	2	4	0	3	4	0	2	4	0	3	4	0	2	4	0	3	4	0	2	4	0	3	4	0	2	4	0	3	4	0	2	4	0	3	4	0	2	4	0	3	4	0	2	2	0	3	2	1	1	5	1	1	3	1	1	4	1	1	5	1	1	3	1	1	4	0	2	2	0	3	2	0	2	2	0	3	2	0	2	2	0	3	2	0	2	2	0	3	2	1	1	4	1	1	5	1	1	3	1	1	4	1	1	5	1	1	3
1	0	3	1	0	4	1	0	5	1	0	3	1	0	4	1	0	5	1	0	3	1	0	4	1	0	5	1	0	3	1	0	4	1	0	5	1	0	3	1	0	4	1	0	5	1	0	3	1	0	4	1	0	5	0	2	1	0	3	1	1	0	5	1	0	3	1	0	4	1	0	5	1	0	3	1	0	4	0	2	3	0	3	3	0	2	3	0	3	3	0	2	3	0	3	3	0	2	3	0	3	3	1	0	4	1	0	5	1	0	3	1	0	4	1	0	5	1	0	3
1	1	3	1	1	4	1	1	5	1	1	3	1	1	4	1	1	5	1	1	3	1	1	4	1	1	5	1	1	3	1	1	4	1	1	5	1	1	3	1	1	4	1	1	5	1	1	3	1	1	4	1	1	5	0	2	2	0	3	2	1	1	5	1	1	3	1	1	4	1	1	5	1	1	3	1	1	4	0	2	4	0	3	4	0	2	4	0	3	4	0	2	4	0	3	4	0	2	4	0	3	4	1	1	4	1	1	5	1	1	3	1	1	4	1	1	5	1	1	3
1	0	3	1	0	4	1	0	5	1	0	3	1	0	4	1	0	5	1	0	3	1	0	4	1	0	5	1	0	3	1	0	4	1	0	5	1	0	3	1	0	4	1	0	5	1	0	3	1	0	4	1	0	5	0	2	1	0	3	1	1	0	5	1	0	3	1	0	4	1	0	5	1	0	3	1	0	4	0	2	1	0	3	1	0	2	1	0	3	1	0	2	1	0	3	1	0	2	1	0	3	1	1	0	4	1	0	5	1	0	3	1	0	4	1	0	5	1	0	3
1	1	3	1	1	4	1	1	5	1	1	3	1	1	4	1	1	5	1	1	3	1	1	4	1	1	5	1	1	3	1	1	4	1	1	5	1	1	3	1	1	4	1	1	5	1	1	3	1	1	4	1	1	5	0	2	2	0	3	2	1	1	5	1	1	3	1	1	4	1	1	5	1	1	3	1	1	4	0	2	2	0	3	2	0	2	2	0	3	2	0	2	2	0	3	2	0	2	2	0	3	2	1	1	4	1	1	5	1	1	3	1	1	4	1	1	5	1	1	3
1	0	3	1	0	4	1	0	5	1	0	3	1	0	4	1	0	5	1	0	3	1	0	4	0	2	1	0	3	1	0	2	1	0	3	1	0	2	1	0	3	1	0	2	1	0	3	1	0	2	1	0	3	1	0	2	1	0	3	1	0	2	1	0	3	1	0	2	1	0	3	1	0	2	1	0	3	1	0	2	1	0	3	1	0	2	1	0	3	1	0	2	1	0	3	1	0	2	1	0	3	1	1	0	4	1	0	5	1	0	3	1	0	4	1	0	5	1	0	3
1	1	3	1	1	4	1	1	5	1	1	3	1	1	4	1	1	5	1	1	3	1	1	4	0	2	2	0	3	2	0	2	2	0	3	2	0	2	2	0	3	2	0	2	2	0	3	2	0	2	2	0	3	2	0	2	2	0	3	2	0	2	2	0	3	2	0	2	2	0	3	2	0	2	2	0	3	2	0	2	2	0	3	2	0	2	2	0	3	2	0	2	2	0	3	2	0	2	2	0	3	2	1	1	4	1	1	5	1	1	3	1	1	4	1	1	5	1	1	3
1	0	3	1	0	4	1	0	5	1	0	3	1	0	4	1	0	5	1	0	3	1	0	4	0	2	3	0	3	3	0	2	3	0	3	3	0	2	3	0	3	3	0	2	3	0	3	3	0	2	3	0	3	3	0	2	3	0	3	3	0	2	3	0	3	3	0	2	3	0	3	3	0	2	3	0	3	3	0	2	3	0	3	3	0	2	3	0	3	3	0	2	3	0	3	3	0	2	3	0	3	3	1	0	4	1	0	5	1	0	3	1	0	4	1	0	5	1	0	3
1	1	3	1	1	4	1	1	5	1	1	3	1	1	4	1	1	5	1	1	3	1	1	4	0	2	4	0	3	4	0	2	4	0	3	4	0	2	4	0	3	4	0	2	4	0	3	4	0	2	4	0	3	4	0	2	4	0	3	4	0	2	4	0	3	4	0	2	4	0	3	4	0	2	4	0	3	4	0	2	4	0	3	4	0	2	4	0	3	4	0	2	4	0	3	4	0	2	4	0	3	4	1	1	4	1	1	5	1	1	3	1	1	4	1	1	5	1	1	3
1	0	3	1	0	4	1	0	5	1	0	3	1	0	4	1	0	5	1	0	3	1	0	4	1	0	5	1	0	3	1	0	4	1	0	5	1	0	3	1	0	4	1	0	5	1	0	3	1	0	4	1	0	5	1	0	3	1	0	4	1	0	5	1	0	3	1	0	4	1	0	5	1	0	3	1	0	4	1	0	5	1	0	3	1	0	4	1	0	5	1	0	3	1	0	4	1	0	5	1	0	3	1	0	4	1	0	5	1	0	3	1	0	4	1	0	5	1	0	3
1	1	3	1	1	4	1	1	5	1	1	3	1	1	4	1	1	5	1	1	3	1	1	4	1	1	5	1	1	3	1	1	4	1	1	5	1	1	3	1	1	4	1	1	5	1	1	3	1	1	4	1	1	5	1	1	3	1	1	4	1	1	5	1	1	3	1	1	4	1	1	5	1	1	3	1	1	4	1	1	5	1	1	3	1	1	4	1	1	5	1	1	3	1	1	4	1	1	5	1	1	3	1	1	4	1	1	5	1	1	3	1	1	4	1	1	5	1	1	3
