-1	0	0	-1	0	0	-1	0	0	-1	0	0	-1	0	0	-1	0	0	-1	0	0	-1	0	0	-1	0	0	-1	0	0	-1	0	0	-1	0	0	-1	0	0	-1	0	0	-1	0	0	-1	0	0	-1	0	0	-1	0	0	-1	0	0	-1	0	0	-1	0	0	-1	0	0	-1	0	0	-1	0	0	-1	0	0	-1	0	0	-1	0	0	-1	0	0	-1	0	0	-1	0	0
-1	0	0	-1	0	0	-1	0	0	-1	0	0	-1	0	0	-1	0	0	-1	0	0	-1	0	0	-1	0	0	-1	0	0	-1	0	0	-1	0	0	-1	0	0	-1	0	0	-1	0	0	-1	0	0	-1	0	0	-1	0	0	-1	0	0	-1	0	0	-1	0	0	-1	0	0	-1	0	0	-1	0	0	-1	0	0	-1	0	0	-1	0	0	-1	0	0	-1	0	0	-1	0	0
-1	0	0	-1	0	0	-1	0	0	-1	0	0	-1	0	0	-1	0	0	-2	74	11	-1	0	0	-1	0	0	-1	0	0	-1	0	0	-2	74	11	-1	0	0	-1	0	0	-1	0	0	-1	0	0	-2	74	11	-1	0	0	-1	0	0	-1	0	0	-1	0	0	-2	74	11	-1	0	0	-1	0	0	-1	0	0	-1	0	0	-1	0	0	-1	0	0	-1	0	0	-1	0	0
-1	0	0	3	1	3	3	1	3	-1	0	0	-1	0	0	1	2	0	-2	74	10	2	13	2	2	13	2	-1	0	0	-1	0	0	-2	74	10	1	3	0	2	13	2	2	13	2	2	13	2	-2	74	10	-1	0	0	-1	0	0	-1	0	0	-1	0	0	-2	74	10	-1	0	0	2	13	2	2	13	2	-1	0	0	-1	0	0	3	1	3	-1	0	0	-1	0	0
-1	0	0	3	1	4	3	1	4	-1	0	0	1	1	6	-1	0	0	-2	74	10	2	12	3	2	12	3	-1	0	0	-1	0	0	-2	74	10	-1	0	0	2	12	3	2	12	3	2	12	3	-2	74	10	-1	0	0	-1	0	0	-1	0	0	-1	0	0	-2	74	10	-1	0	0	2	12	3	2	12	3	-1	0	0	-1	0	0	3	1	4	-1	0	0	-1	0	0
-1	0	0	-2	22	-3	-2	22	-9	-1	0	0	-1	0	0	-1	0	0	-2	74	10	-1	0	0	-1	0	0	-1	0	0	-1	0	0	-2	74	10	-1	0	0	-1	0	0	-1	0	0	-1	0	0	-2	74	10	-1	0	0	-1	0	0	-1	0	0	-1	0	0	-2	74	10	-1	0	0	-1	0	0	-1	0	0	-1	0	0	-2	22	-3	-2	22	-11	-2	22	-9	-1	0	0
-1	0	0	-1	0	0	-1	0	0	-1	0	0	-1	0	0	-1	0	0	-2	74	14	-1	0	0	-1	0	0	-1	0	0	-1	0	0	-2	74	14	-1	0	0	-1	0	0	-1	0	0	-1	0	0	-2	74	14	-1	0	0	-1	0	0	-1	0	0	-1	0	0	-2	74	14	-1	0	0	-1	0	0	-1	0	0	-1	0	0	-1	0	0	-1	0	0	-1	0	0	-1	0	0
-2	22	51	-1	0	0	1	2	6	-1	0	0	-1	0	0	-1	0	0	-1	0	0	-1	0	0	-1	0	0	-1	0	0	-1	0	0	-1	0	0	-1	0	0	-1	0	0	-1	0	0	-1	0	0	-1	0	0	-1	0	0	-1	0	0	-1	0	0	-1	0	0	-1	0	0	-1	0	0	-1	0	0	-1	0	0	-1	0	0	-1	0	0	-1	0	0	-1	0	0	-1	0	0
-2	22	54	-1	0	0	1	2	7	1	2	6	-1	0	0	-1	0	0	-1	0	0	-1	0	0	-1	0	0	-1	0	0	-1	0	0	-1	0	0	-1	0	0	-1	0	0	-1	0	0	-1	0	0	-1	0	0	-1	0	0	-1	0	0	-1	0	0	-1	0	0	-1	0	0	-1	0	0	-1	0	0	-1	0	0	-1	0	0	-1	0	0	-1	0	0	-1	0	0	-1	0	0
-1	0	0	-1	0	0	1	2	6	1	2	7	-1	0	0	-1	0	0	-1	0	0	-1	0	0	-1	0	0	-1	0	0	-1	0	0	1	4	10	-1	0	0	4	15	5	4	15	5	-1	0	0	1	4	10	-1	0	0	-1	0	0	-1	0	0	-1	0	0	1	4	10	-1	0	0	-1	0	0	-1	0	0	-1	0	0	-1	0	0	-1	0	0	4	14	6	4	15	6
-1	0	0	1	0	13	1	2	7	1	2	6	-1	0	0	-1	0	0	-1	0	0	-1	0	0	-1	0	0	-1	0	0	-1	0	0	1	4	11	-1	0	0	-1	0	0	-1	0	0	-1	0	0	1	4	11	-1	0	0	-1	0	0	-1	0	0	-1	0	0	1	4	11	-1	0	0	-1	0	0	-1	0	0	-1	0	0	-1	0	0	-1	0	0	4	14	7	4	15	7
-1	0	0	1	0	14	-1	0	0	1	2	7	-1	0	0	-1	0	0	-1	0	0	4	15	5	-1	0	0	-1	0	0	-1	0	0	1	4	12	-1	0	0	-1	0	0	-1	0	0	-1	0	0	1	4	12	-1	0	0	-1	0	0	-1	0	0	-1	0	0	1	4	12	-1	0	0	-1	0	0	-1	0	0	4	15	5	-1	0	0	-1	0	0	4	15	5	-1	0	0
-1	0	0	1	0	15	-1	0	0	-1	0	0	-1	0	0	-1	0	0	-1	0	0	-1	0	0	-1	0	0	-1	0	0	-1	0	0	-1	0	0	-1	0	0	-1	0	0	-1	0	0	-1	0	0	-1	0	0	-1	0	0	-1	0	0	-1	0	0	-1	0	0	-1	0	0	-1	0	0	-1	0	0	-1	0	0	-1	0	0	-1	0	0	4	15	5	4	15	5	4	15	5
1	2	6	-1	0	0	-1	0	0	-1	0	0	-1	0	0	-1	0	0	-1	0	0	-1	0	0	-1	0	0	-1	0	0	-1	0	0	-1	0	0	-1	0	0	-1	0	0	-1	0	0	-1	0	0	-1	0	0	-1	0	0	-1	0	0	-1	0	0	-1	0	0	-1	0	0	-1	0	0	-1	0	0	-1	0	0	-1	0	0	-1	0	0	-1	0	0	-1	0	0	-2	22	-55
1	2	7	1	0	13	-1	0	0	-1	0	0	-1	0	0	-1	0	0	-1	0	0	-1	0	0	-1	0	0	-1	0	0	-1	0	0	-1	0	0	-1	0	0	-1	0	0	-1	0	0	-1	0	0	-1	0	0	-1	0	0	-1	0	0	-1	0	0	-1	0	0	-1	0	0	-1	0	0	-1	0	0	-1	0	0	-1	0	0	1	9	0	-1	0	0	-1	0	0	-2	22	-52
1	2	6	1	0	14	-1	0	0	-1	0	0	-1	0	0	-1	0	0	-1	0	0	-1	0	0	-1	0	0	-1	0	0	-1	0	0	-1	0	0	-1	0	0	-1	0	0	-1	0	0	-1	0	0	-1	0	0	-1	0	0	-1	0	0	-1	0	0	-1	0	0	-1	0	0	-1	0	0	-1	0	0	-1	0	0	-1	0	0	-1	0	0	-1	0	0	1	8	0	1	9	0
1	2	7	1	0	15	-1	0	0	-1	0	0	-1	0	0	-1	0	0	-1	0	0	-1	0	0	-1	0	0	-1	0	0	-1	0	0	-1	0	0	-1	0	0	-1	0	0	-1	0	0	-1	0	0	-1	0	0	-1	0	0	4	15	5	-1	0	0	-1	0	0	-1	0	0	-1	0	0	-1	0	0	-1	0	0	-1	0	0	-1	0	0	-1	0	0	1	8	1	1	9	1
-1	0	0	-1	0	0	-1	0	0	-1	0	0	-1	0	0	-1	0	0	4	15	5	-1	0	0	-1	0	0	-1	0	0	-1	0	0	1	4	10	-1	0	0	-1	0	0	-1	0	0	-1	0	0	1	4	10	-1	0	0	-1	0	0	-1	0	0	-1	0	0	1	4	10	-1	0	0	-1	0	0	-1	0	0	1	10	0	1	11	0	-1	0	0	-1	0	0	-2	22	-55
-1	0	0	1	7	12	1	7	12	-1	0	0	-1	0	0	-1	0	0	-1	0	0	-1	0	0	-1	0	0	-1	0	0	-1	0	0	1	4	11	-1	0	0	-1	0	0	-1	0	0	-1	0	0	1	4	11	-1	0	0	-1	0	0	-1	0	0	-1	0	0	1	4	11	-1	0	0	-1	0	0	-1	0	0	1	10	1	1	11	1	-1	0	0	-1	0	0	-2	22	-52
-1	0	0	1	5	11	1	5	11	-1	0	0	-1	0	0	-1	0	0	-1	0	0	-1	0	0	-1	0	0	-1	0	0	-1	0	0	1	4	12	-1	0	0	-1	0	0	-1	0	0	-1	0	0	1	4	12	-1	0	0	-1	0	0	-1	0	0	-1	0	0	1	4	12	-1	0	0	-1	0	0	-1	0	0	-1	0	0	-1	0	0	-1	0	0	4	15	5	4	15	5
-1	0	0	-1	0	0	-1	0	0	-1	0	0	-1	0	0	-1	0	0	-1	0	0	-1	0	0	-1	0	0	-1	0	0	-1	0	0	-1	0	0	-1	0	0	-1	0	0	-1	0	0	-1	0	0	-1	0	0	-1	0	0	-1	0	0	-1	0	0	-1	0	0	-1	0	0	-1	0	0	-1	0	0	4	15	5	-1	0	0	-1	0	0	-1	0	0	4	15	5	4	15	5
-2	22	51	-1	0	0	-1	0	0	-1	0	0	-1	0	0	-1	0	0	-1	0	0	-1	0	0	-1	0	0	-1	0	0	-1	0	0	-1	0	0	-1	0	0	-1	0	0	-1	0	0	-1	0	0	-1	0	0	-1	0	0	-1	0	0	-1	0	0	-1	0	0	-1	0	0	4	15	5	-1	0	0	-1	0	0	-1	0	0	-1	0	0	-1	0	0	4	15	5	-1	0	0
-2	22	54	-1	0	0	-1	0	0	-1	0	0	-1	0	0	-1	0	0	-1	0	0	-1	0	0	-1	0	0	-1	0	0	-1	0	0	-1	0	0	-1	0	0	-1	0	0	-1	0	0	-1	0	0	-1	0	0	-1	0	0	-1	0	0	-1	0	0	4	15	5	4	15	5	4	15	5	4	15	5	-1	0	0	-1	0	0	-1	0	0	-1	0	0	-1	0	0	4	15	5
-1	0	0	-1	0	0	-1	0	0	-1	0	0	-1	0	0	-1	0	0	-1	0	0	-1	0	0	-1	0	0	-1	0	0	-1	0	0	-1	0	0	-1	0	0	-1	0	0	-1	0	0	-1	0	0	-1	0	0	-1	0	0	-1	0	0	-1	0	0	-1	0	0	-1	0	0	-1	0	0	-1	0	0	-1	0	0	-1	0	0	-1	0	0	-1	0	0	-1	0	0	-1	0	0
-1	0	0	-1	0	0	-1	0	0	-1	0	0	-1	0	0	-1	0	0	-1	0	0	-1	0	0	-1	0	0	-1	0	0	-1	0	0	-1	0	0	-1	0	0	-1	0	0	-1	0	0	-1	0	0	-1	0	0	-1	0	0	-1	0	0	-1	0	0	-1	0	0	-1	0	0	-1	0	0	-1	0	0	-1	0	0	-1	0	0	-1	0	0	-1	0	0	-1	0	0	-1	0	0
