-1	0	0	-1	0	0	-1	0	0	-1	0	0	-1	0	0	-1	0	0	-1	0	0	-1	0	0	-1	0	0	-1	0	0	-1	0	0	-1	0	0	-1	0	0	-1	0	0	-1	0	0	-1	0	0	-1	0	0	-1	0	0	-1	0	0	-1	0	0
-1	0	0	-1	0	0	-1	0	0	-1	0	0	-1	0	0	-1	0	0	-1	0	0	-1	0	0	-1	0	0	-1	0	0	-1	0	0	-1	0	0	-1	0	0	-1	0	0	-1	0	0	-1	0	0	-1	0	0	-1	0	0	-1	0	0	-1	0	0
-1	0	0	-1	0	0	-1	0	0	-1	0	0	-1	0	0	-1	0	0	-1	0	0	-1	0	0	-1	0	0	-1	0	0	-1	0	0	-1	0	0	-1	0	0	-1	0	0	-1	0	0	-1	0	0	-1	0	0	-1	0	0	-1	0	0	-1	0	0
0	2	4	0	3	4	0	2	4	0	3	4	0	2	4	0	3	4	0	2	4	0	3	4	0	2	4	0	3	4	0	2	4	0	3	4	0	2	4	0	3	4	0	2	4	0	3	4	0	2	4	0	3	4	0	4	4	-1	0	0
0	2	5	0	2	5	0	2	5	0	2	5	0	2	5	0	2	5	0	2	5	0	2	5	0	2	5	0	2	5	0	2	5	0	2	5	0	2	5	0	2	5	0	2	5	0	2	5	0	2	5	0	3	5	0	4	5	-1	0	0
0	3	5	0	3	5	0	3	5	0	3	5	0	3	5	0	3	5	0	3	5	0	3	5	0	3	5	0	3	5	0	3	5	0	3	5	0	3	5	0	3	5	0	3	5	0	3	5	0	3	5	0	3	5	0	4	5	-1	0	0
0	2	5	0	2	5	0	2	5	0	2	5	0	2	5	0	2	5	0	2	5	0	2	5	0	2	5	0	2	5	0	2	5	0	2	5	0	2	5	0	2	5	0	2	5	0	2	5	0	2	5	0	2	5	0	4	5	-1	0	0
0	3	5	0	3	5	0	3	5	0	3	5	0	3	5	0	3	5	0	3	5	0	3	5	0	3	5	0	3	5	0	3	5	0	3	5	0	3	5	0	3	5	0	3	5	0	3	5	0	3	5	0	3	5	0	4	5	-1	0	0
0	2	5	0	2	5	0	2	5	0	2	5	0	2	5	0	2	5	0	2	5	0	2	5	0	2	5	0	2	5	0	2	5	0	2	5	0	2	5	0	2	5	0	2	5	0	2	5	0	2	5	0	2	5	0	4	5	-1	0	0
0	3	5	0	3	5	0	3	5	0	3	5	0	3	5	0	3	5	0	3	5	0	3	5	0	3	5	0	3	5	0	3	5	0	3	5	0	3	5	0	3	5	0	3	5	0	3	5	0	3	5	0	3	5	0	4	5	-1	0	0
0	2	5	0	2	5	0	2	5	0	2	5	0	2	5	0	2	5	0	2	5	0	2	5	0	2	5	0	2	5	0	2	5	0	2	5	0	2	5	0	2	5	0	2	5	0	2	5	0	2	5	0	2	5	0	4	5	-1	0	0
0	3	5	0	3	5	0	3	5	0	3	5	0	3	5	0	3	5	0	3	5	0	3	5	0	3	5	0	3	5	0	3	5	0	3	5	0	3	5	0	3	5	0	3	5	0	3	5	0	3	5	0	3	5	0	4	5	-1	0	0
0	1	6	0	2	6	0	3	6	0	2	6	0	3	6	0	2	6	0	3	6	0	2	6	0	3	6	0	2	6	0	3	6	0	2	6	0	3	6	0	2	6	0	3	6	0	2	6	0	3	6	0	3	6	0	4	6	-1	0	0
-1	0	0	-1	0	0	-1	0	0	-1	0	0	-1	0	0	-1	0	0	-1	0	0	-1	0	0	-1	0	0	-1	0	0	-1	0	0	-1	0	0	-1	0	0	-1	0	0	-1	0	0	-1	0	0	-1	0	0	-1	0	0	-1	0	0	-1	0	0
-1	0	0	-1	0	0	-1	0	0	-1	0	0	-1	0	0	-1	0	0	-1	0	0	-1	0	0	-1	0	0	-1	0	0	-1	0	0	-1	0	0	-1	0	0	-1	0	0	-1	0	0	-1	0	0	-1	0	0	-1	0	0	-1	0	0	-1	0	0
