-2	0	0	-2	0	0	-2	0	0	-2	0	0	-2	0	0	-2	0	0	-2	0	0	-2	0	0	-2	0	0	-2	0	0	-2	0	0	-2	0	0	-2	0	0	-2	0	0	-2	0	0	-2	0	0	-2	0	0	-2	0	0	-2	0	0	-2	0	0	-2	0	0	-2	0	0	-2	0	0	-2	0	0	-2	0	0	-2	0	0	-2	0	0	-2	0	0	-2	0	0	-2	0	0	-2	0	0	-2	0	0	-2	0	0	-2	0	0	-2	0	0	-2	0	0	-2	0	0	-2	0	0	-2	0	0	-2	0	0
-2	0	0	-2	0	0	-2	0	0	-2	0	0	-2	0	0	-2	0	0	-2	0	0	-2	0	0	-2	0	0	-2	0	0	-2	0	0	-2	0	0	-2	0	0	-2	0	0	-2	0	0	-2	0	0	-2	0	0	-2	0	0	-2	0	0	-2	0	0	-2	0	0	-2	0	0	-2	0	0	-2	0	0	-2	0	0	-2	0	32	-2	0	36	-2	0	100	-2	0	100	-2	0	100	-2	0	100	-2	0	100	-2	0	100	-2	0	100	-2	0	100	-2	0	68	-2	0	64	-2	0	0	-2	0	0	-2	0	0
-2	0	0	-2	0	0	-2	0	0	-2	0	0	-2	0	0	-2	0	0	-2	0	0	-2	0	0	-2	0	0	-2	0	0	-2	0	0	-2	0	0	-2	0	0	-2	0	0	-2	0	0	-2	0	0	-2	0	0	-2	0	0	-2	0	0	-2	0	0	-2	0	0	-2	0	0	-2	0	0	-2	0	0	-2	0	0	-2	0	34	0	14	21	0	15	21	0	14	21	0	15	21	0	14	21	0	15	21	0	14	21	0	15	21	0	14	21	0	15	21	-2	0	72	-2	0	0	-2	0	0	-2	0	0
-2	0	0	-2	0	0	-2	0	0	-2	0	0	-2	0	0	-2	0	0	-2	0	0	-2	0	0	-2	0	0	-2	0	0	-2	0	0	-2	0	0	-2	0	0	-2	0	0	-2	0	0	-2	0	0	-2	0	0	-2	0	0	-2	0	0	-2	0	0	-2	0	0	-2	0	0	-2	0	0	-2	0	0	-2	0	0	-2	0	50	0	14	22	0	15	22	0	14	22	0	15	22	0	14	22	0	15	22	0	14	22	0	15	22	0	14	22	0	15	22	-2	0	-56	-2	0	0	-2	0	0	-2	0	0
-2	0	0	-2	0	0	-2	0	0	-2	0	0	-2	0	0	-2	0	0	-2	0	0	-2	0	0	-2	0	0	-2	0	0	-2	0	0	-2	0	0	-2	0	0	-2	0	0	-2	0	0	-2	0	0	-2	0	0	-2	0	0	-2	0	0	-2	0	0	-2	0	0	-2	0	0	-2	0	0	-2	0	0	-2	0	0	-2	0	50	0	14	23	0	15	23	0	14	23	0	15	23	0	14	23	0	15	23	0	14	23	0	15	23	0	14	23	0	15	23	-2	0	-56	-2	0	0	-2	0	0	-2	0	0
-2	0	0	-2	0	0	-2	0	0	-2	0	0	-2	0	0	-2	0	0	-2	0	0	-2	0	0	-2	0	0	-2	0	0	-2	0	0	-2	0	0	-2	0	0	-2	0	0	-2	0	0	-2	0	0	-2	0	0	-2	0	0	-2	0	0	-2	0	0	-2	0	0	-2	0	0	-2	0	0	-2	0	0	-2	0	0	-2	0	50	0	14	24	0	15	24	0	14	24	0	15	24	0	14	24	0	15	24	0	14	24	0	15	24	0	14	24	0	15	24	-2	0	-56	-2	0	0	-2	0	0	-2	0	0
-2	0	0	-2	0	0	-2	0	0	-2	0	0	-2	0	0	-2	0	0	-2	0	0	-2	0	0	-2	0	0	-2	0	0	-2	0	0	-2	0	0	-2	0	0	-2	0	0	-2	0	0	-2	0	0	-2	0	0	-2	0	0	-2	0	0	-2	0	0	-2	0	0	-2	0	0	-2	0	0	-2	0	0	-2	0	0	-2	0	50	0	14	21	0	15	21	0	14	21	0	15	21	0	14	21	0	15	21	0	14	21	0	15	21	0	14	21	0	15	21	-2	0	-56	-2	0	0	-2	0	0	-2	0	0
-2	0	0	-2	0	0	-2	0	0	-2	0	0	-2	0	0	-2	0	0	-2	0	0	-2	0	0	-2	0	0	-2	0	0	-2	0	0	-2	0	0	-2	0	0	-2	0	0	-2	0	0	-2	0	0	-2	0	0	-2	0	0	-2	0	0	-2	0	0	-2	0	0	-2	0	0	-2	0	0	-2	0	0	-2	0	0	-2	0	50	0	14	22	0	15	22	0	14	22	0	15	22	0	14	22	0	15	22	0	14	22	0	15	22	0	14	22	0	15	22	-2	0	-56	-2	0	0	-2	0	0	-2	0	0
-2	0	0	-2	0	0	-2	0	0	-2	0	0	-2	0	0	-2	0	0	-2	0	0	-2	0	0	-2	0	0	-2	0	0	-2	0	0	-2	0	0	-2	0	0	-2	0	0	-2	0	0	-2	0	0	-2	0	0	-2	0	0	-2	0	0	-2	0	0	-2	0	0	-2	0	0	-2	0	0	-2	0	0	-2	0	0	-2	0	50	0	14	23	0	15	23	0	14	23	0	15	23	0	14	23	0	15	23	0	14	23	0	15	23	0	14	23	0	15	23	-2	0	-56	-2	0	0	-2	0	0	-2	0	0
-2	0	0	-2	0	0	-2	0	0	-2	0	0	-2	0	0	-2	0	0	-2	0	0	-2	0	0	-2	0	0	-2	0	0	-2	0	0	-2	0	0	-2	0	0	-2	0	0	-2	0	0	-2	0	0	-2	0	0	-2	0	0	-2	0	0	-2	0	0	-2	0	0	-2	0	0	-2	0	0	-2	0	0	-2	0	0	-2	0	18	0	14	24	0	15	24	0	14	24	0	15	24	0	14	24	0	15	24	0	14	24	0	15	24	0	14	24	0	15	24	-2	0	-120	-2	0	0	-2	0	0	-2	0	0
-2	0	0	-2	0	0	-2	0	0	-2	0	0	-2	0	0	-2	0	0	-2	0	0	-2	0	0	-2	0	0	-2	0	0	-2	0	0	-2	0	0	-2	0	0	-2	0	0	-2	0	0	-2	0	0	-2	0	0	-2	0	0	-2	0	0	-2	0	0	-2	0	0	-2	0	0	-2	0	0	-2	0	0	-2	0	0	-2	0	16	-2	0	17	-2	0	-111	-2	0	-111	-2	0	-111	-2	0	-111	-2	0	-111	-2	0	-111	-2	0	-111	-2	0	-111	-2	0	-127	-2	0	-128	-2	0	0	-2	0	0	-2	0	0
-2	0	0	-2	0	0	-2	0	0	-2	0	0	-2	0	0	-2	0	0	-2	0	0	-2	0	0	-2	0	0	-2	0	0	-2	0	0	-2	0	0	-2	0	0	-2	0	0	-2	0	0	-2	0	0	-2	0	0	-2	0	0	-2	0	0	-2	0	0	-2	0	0	-2	0	0	-2	0	0	-2	0	0	-2	0	0	-2	0	0	-2	0	0	-2	0	0	-2	0	0	-2	0	0	-2	0	0	-2	0	0	-2	0	0	-2	0	0	-2	0	0	-2	0	0	-2	0	0	-2	0	0	-2	0	0	-2	0	0
-2	0	0	-2	0	0	-2	0	0	-2	0	0	-2	0	0	-2	0	0	-2	0	0	-2	0	0	-2	0	0	-2	0	0	-2	0	0	-2	0	0	-2	0	0	-2	0	0	-2	0	0	-2	0	0	-2	0	0	-2	0	0	-2	0	0	-2	0	0	-2	0	0	-2	0	0	-2	0	0	-2	0	0	-2	0	0	-2	0	0	-2	0	0	-2	0	0	-2	0	0	-2	0	0	-2	0	0	-2	0	0	-2	0	0	-2	0	0	-2	0	0	-2	0	0	-2	0	0	-2	0	0	-2	0	0	-2	0	0
-2	0	0	-2	0	0	-2	0	0	-2	0	0	-2	0	0	-2	0	0	-2	0	0	-2	0	0	-2	0	0	-2	0	0	-2	0	0	-2	0	0	-2	0	0	-2	0	0	-2	0	0	-2	0	0	-2	0	0	-2	0	0	-2	0	0	-2	0	0	-2	0	0	-2	0	0	-2	0	0	-2	0	0	-2	0	0	-2	0	0	-2	0	0	-2	0	0	-2	0	0	-2	0	0	-2	0	0	-2	0	0	-2	0	0	-2	0	0	-2	0	0	-2	0	0	-2	0	0	-2	0	0	-2	0	0	-2	0	0
-2	0	0	-2	0	0	-2	0	0	-2	0	0	-2	0	0	-2	0	0	-2	0	0	-2	0	0	-2	0	0	-2	0	0	-2	0	0	-2	0	0	-2	0	0	-2	0	0	-2	0	0	-2	0	0	-2	0	0	-2	0	0	-2	0	0	-2	0	0	-2	0	0	-2	0	0	-2	0	0	-2	0	0	-2	0	0	-2	0	0	-2	0	0	-2	0	0	-2	0	0	-2	0	0	-2	0	0	-2	0	0	-2	0	0	-2	0	0	-2	0	0	-2	0	0	-2	0	0	-2	0	0	-2	0	0	-2	0	0
-2	0	0	-2	0	0	-2	0	0	-2	0	0	-2	0	0	-2	0	0	-2	0	0	-2	0	0	-2	0	0	-2	0	0	-2	0	0	-2	0	0	-2	0	0	-2	0	0	-2	0	0	-2	0	0	-2	0	0	-2	0	0	-2	0	0	-2	0	0	-2	0	0	-2	0	0	-2	0	0	-2	0	0	-2	0	0	-2	0	0	-2	0	0	-2	0	0	-2	0	0	-2	0	0	-2	0	0	-2	0	0	-2	0	0	-2	0	0	-2	0	0	-2	0	0	-2	0	0	-2	0	0	-2	0	0	-2	0	0
-2	0	0	-2	0	0	-2	0	0	-2	0	0	-2	0	0	-2	0	0	-2	0	0	-2	0	0	-2	0	0	-2	0	0	-2	0	0	-2	0	0	-2	0	0	-2	0	0	-2	0	0	-2	0	0	-2	0	0	-2	0	0	-2	0	0	-2	0	0	-2	0	0	-2	0	0	-2	0	0	-2	0	0	-2	0	0	-2	0	0	-2	0	0	-2	0	0	-2	0	0	-2	0	0	-2	0	0	-2	0	0	-2	0	0	-2	0	0	-2	0	0	-2	0	0	-2	0	0	-2	0	0	-2	0	0	-2	0	0
-2	0	0	-2	0	0	-2	0	0	-2	0	0	-2	0	0	-2	0	0	-2	0	0	-2	0	0	-2	0	0	-2	0	0	-2	0	0	-2	0	0	-2	0	0	-2	0	0	-2	0	0	-2	0	0	-2	0	0	-2	0	0	-2	0	0	-2	0	0	-2	0	0	-2	0	0	-2	0	0	-2	0	0	-2	0	0	-2	0	0	-2	0	0	-2	0	0	-2	0	0	-2	0	0	-2	0	0	-2	0	0	-2	0	0	-2	0	0	-2	0	0	-2	0	0	-2	0	0	-2	0	0	-2	0	0	-2	0	0
-2	0	0	-2	0	0	-2	0	0	-2	0	0	-2	0	0	-2	0	0	-2	0	0	-2	0	0	-2	0	0	-2	0	0	-2	0	0	-2	0	0	-2	0	0	-2	0	0	-2	0	0	-2	0	0	-2	0	0	-2	0	0	-2	0	0	-2	0	0	-2	0	0	-2	0	0	-2	0	0	-2	0	0	-2	0	0	-2	0	0	-2	0	0	-2	0	0	-2	0	0	-2	0	0	-2	0	0	-2	0	0	-2	0	0	-2	0	0	-2	0	0	-2	0	0	-2	0	0	-2	0	0	-2	0	0	-2	0	0
-2	0	0	-2	0	0	-2	0	0	-2	0	0	-2	0	0	-2	0	0	-2	0	0	-2	0	0	-2	0	0	-2	0	0	-2	0	0	-2	0	0	-2	0	0	-2	0	0	-2	0	0	-2	0	0	-2	0	0	-2	0	0	-2	0	0	-2	0	0	-2	0	0	-2	0	0	-2	0	0	-2	0	0	-2	0	0	-2	0	0	-2	0	0	-2	0	0	-2	0	0	-2	0	0	-2	0	0	-2	0	0	-2	0	0	-2	0	0	-2	0	0	-2	0	0	-2	0	0	-2	0	0	-2	0	0	-2	0	0
-2	0	0	-2	0	0	-2	0	0	-2	0	0	-2	0	0	-2	0	0	-2	0	0	-2	0	0	-2	0	0	-2	0	0	-2	0	0	-2	0	0	-2	0	0	-2	0	0	-2	0	0	-2	0	0	-2	0	0	-2	0	0	-2	0	0	-2	0	0	-2	0	0	-2	0	0	-2	0	0	-2	0	0	-2	0	0	-2	0	0	-2	0	0	-2	0	0	-2	0	0	-2	0	0	-2	0	0	-2	0	0	-2	0	0	-2	0	0	-2	0	0	-2	0	0	-2	0	0	-2	0	0	-2	0	0	-2	0	0
-2	0	0	-2	0	0	-2	0	0	-2	0	0	-2	0	0	-2	0	0	-2	0	0	-2	0	0	-2	0	0	-2	0	0	-2	0	0	-2	0	0	-2	0	0	-2	0	0	-2	0	0	-2	0	0	-2	0	0	-2	0	0	-2	0	0	-2	0	0	-2	0	0	-2	0	0	-2	0	0	-2	0	0	-2	0	0	-2	0	0	-2	0	0	-2	0	0	-2	0	0	-2	0	0	-2	0	0	-2	0	0	-2	0	0	-2	0	0	-2	0	0	-2	0	0	-2	0	0	-2	0	0	-2	0	0	-2	0	0
-2	0	0	-2	0	0	-2	0	0	-2	0	0	-2	0	0	-2	0	0	-2	0	0	-2	0	0	-2	0	0	-2	0	0	-2	0	0	-2	0	0	-2	0	0	-2	0	0	-2	0	0	-2	0	0	-2	0	0	-2	0	0	-2	0	0	-2	0	0	-2	0	0	-2	0	0	-2	0	0	-2	0	0	-2	0	0	-2	0	0	-2	0	0	-2	0	0	-2	0	0	-2	0	0	-2	0	0	-2	0	0	-2	0	0	-2	0	0	-2	0	0	-2	0	0	-2	0	0	-2	0	0	-2	0	0	-2	0	0
-2	0	0	-2	0	0	-2	0	0	-2	0	0	-2	0	0	-2	0	0	-2	0	0	-2	0	0	-2	0	0	-2	0	0	-2	0	0	-2	0	0	-2	0	0	-2	0	0	-2	0	0	-2	0	0	-2	0	0	-2	0	0	-2	0	0	-2	0	0	-2	0	0	-2	0	0	-2	0	0	-2	0	0	-2	0	0	-2	0	0	-2	0	0	-2	0	0	-2	0	0	-2	0	0	-2	0	0	-2	0	0	-2	0	0	-2	0	0	-2	0	0	-2	0	0	-2	0	0	-2	0	0	-2	0	0	-2	0	0
-2	0	0	-2	0	0	-2	0	0	-2	0	0	-2	0	0	-2	0	0	-2	0	0	-2	0	0	-2	0	0	-2	0	0	-2	0	0	-2	0	0	-2	0	0	-2	0	0	-2	0	0	-2	0	0	-2	0	0	-2	0	0	-2	0	0	-2	0	0	-2	0	0	-2	0	0	-2	0	0	-2	0	0	-2	0	0	-2	0	0	-2	0	0	-2	0	0	-2	0	0	-2	0	0	-2	0	0	-2	0	0	-2	0	0	-2	0	0	-2	0	0	-2	0	0	-2	0	0	-2	0	0	-2	0	0	-2	0	0
-2	0	0	-2	0	0	-2	0	0	-2	0	0	-2	0	0	-2	0	0	-2	0	0	-2	0	0	-2	0	0	-2	0	0	-2	0	0	-2	0	0	-2	0	0	-2	0	0	-2	0	0	-2	0	0	-2	0	0	-2	0	0	-2	0	0	-2	0	0	-2	0	0	-2	0	0	-2	0	0	-2	0	0	-2	0	0	-2	0	0	-2	0	0	-2	0	0	-2	0	0	-2	0	0	-2	0	0	-2	0	0	-2	0	0	-2	0	0	-2	0	0	-2	0	0	-2	0	0	-2	0	0	-2	0	0	-2	0	0
-2	0	0	-2	0	0	-2	0	0	-2	0	0	-2	0	0	-2	0	0	-2	0	0	-2	0	0	-2	0	0	-2	0	0	-2	0	0	-2	0	0	-2	0	0	-2	0	0	-2	0	0	-2	0	0	-2	0	0	-2	0	0	-2	0	0	-2	0	0	-2	0	0	-2	0	0	-2	0	0	-2	0	0	-2	0	0	-2	0	0	-2	0	0	-2	0	0	-2	0	0	-2	0	0	-2	0	0	-2	0	0	-2	0	0	-2	0	0	-2	0	0	-2	0	0	-2	0	0	-2	0	0	-2	0	0	-2	0	0
-2	0	0	-2	0	0	-2	0	0	-2	0	0	-2	0	0	-2	0	0	-2	0	0	-2	0	0	-2	0	0	-2	0	0	-2	0	0	-2	0	0	-2	0	0	-2	0	0	-2	0	0	-2	0	0	-2	0	0	-2	0	0	-2	0	0	-2	0	0	-2	0	0	-2	0	0	-2	0	0	-2	0	0	-2	0	0	-2	0	0	-2	0	0	-2	0	0	-2	0	0	-2	0	0	-2	0	0	-2	0	0	-2	0	0	-2	0	0	-2	0	0	-2	0	0	-2	0	0	-2	0	0	-2	0	0	-2	0	0
-2	0	0	-2	0	0	-2	0	0	-2	0	0	-2	0	0	-2	0	0	-2	0	0	-2	0	0	-2	0	0	-2	0	0	-2	0	0	-2	0	0	-2	0	0	-2	0	0	-2	0	0	-2	0	0	-2	0	0	-2	0	0	-2	0	0	-2	0	0	-2	0	0	-2	0	0	-2	0	0	-2	0	0	-2	0	0	-2	0	0	-2	0	0	-2	0	0	-2	0	0	-2	0	0	-2	0	0	-2	0	0	-2	0	0	-2	0	0	-2	0	0	-2	0	0	-2	0	0	-2	0	0	-2	0	0	-2	0	0
-2	0	0	-2	0	0	-2	0	0	-2	0	0	-2	0	0	-2	0	0	-2	0	0	-2	0	0	-2	0	0	-2	0	0	-2	0	0	-2	0	0	-2	0	0	-2	0	0	-2	0	0	-2	0	0	-2	0	0	-2	0	0	-2	0	0	-2	0	0	-2	0	0	-2	0	0	-2	0	0	-2	0	0	-2	0	0	-2	0	0	-2	0	0	-2	0	0	-2	0	0	-2	0	0	-2	0	0	-2	0	0	-2	0	0	-2	0	0	-2	0	0	-2	0	0	-2	0	0	-2	0	0	-2	0	0	-2	0	0
